Permit_Key,Ward_ID,Est_Const_Cost,Application_Date_Key,Issued_Date_Key,Completed_Date_Key,Application_to_Issuance_Duration,Avg_App_to_Issuance_Duration_by_Year,Avg_Est_Const_Cost_by_Ward,Avg_Est_Const_Cost_by_Year
1,13,1200000,740,767,5959,27,202.94,7795654.71978022,7117555.88
2,22,650000,1783,1864,6283,81,423.81,2904103.2512077293,11229609.36
3,11,700000,2543,2560,6214,17,230.03,1820371.57,14812242.86
4,5,2000000,2735,3909,6198,1174,417.96,1400922.5020242915,14954908.92
5,12,1500000,2844,2889,5944,45,417.96,7658937.101338432,14954908.92
6,15,600000,2920,2969,6051,49,417.96,4522577.48037889,14954908.92
7,4,2000000,3186,3510,6142,324,281.46,4297914.794871795,11503993.02
8,4,2000000,3186,3510,6142,324,281.46,4297914.794871795,11503993.02
9,4,2000000,3186,3510,6225,324,281.46,4297914.794871795,11503993.02
10,4,2000000,3186,3510,6198,324,281.46,4297914.794871795,11503993.02
11,4,2000000,3186,3510,6198,324,281.46,4297914.794871795,11503993.02
12,4,2000000,3186,3510,6197,324,281.46,4297914.794871795,11503993.02
13,4,2000000,3186,3510,6224,324,281.46,4297914.794871795,11503993.02
14,24,190000000,3229,3838,6254,609,281.46,23456062.532786883,11503993.02
15,12,1000000,3295,3391,6148,96,281.46,7658937.101338432,11503993.02
16,4,525000,3420,3771,6032,351,205.39,4297914.794871795,9006193.27
17,21,1500000,3512,3666,6101,154,205.39,17091199.984,9006193.27
18,21,5670000,3715,3764,5959,49,205.39,17091199.984,9006193.27
19,2,82000000,3733,5069,6275,1336,205.39,2989003.2716499544,9006193.27
20,17,3800000,3792,3959,6234,167,312.72,1614143.0049603174,13350024.59
21,18,81000000,3826,4722,6039,896,312.72,8584355.493548388,13350024.59
22,21,30000000,3831,5787,6235,1956,312.72,17091199.984,13350024.59
23,4,650000,3840,4014,6240,174,312.72,4297914.794871795,13350024.59
24,3,1040000,3904,3923,6213,19,312.72,9246769.549865229,13350024.59
25,19,554190,3908,3959,6210,51,312.72,6721340.5708154505,13350024.59
26,16,900000,3952,3984,5959,32,312.72,2465023.1840707962,13350024.59
27,24,25000000,3971,4464,6207,493,312.72,23456062.532786883,13350024.59
28,3,150000000,4002,4464,6078,462,312.72,9246769.549865229,13350024.59
29,11,737000,4085,4132,6014,47,312.72,1820371.57,13350024.59
30,24,65000000,4092,4960,5973,868,312.72,23456062.532786883,13350024.59
31,21,4100000,4203,4226,5959,23,248.15,17091199.984,12693718.64
32,3,1600000,4267,4294,6213,27,248.15,9246769.549865229,12693718.64
33,24,61000000,4268,5191,6261,923,248.15,23456062.532786883,12693718.64
34,11,795000,4274,4292,6077,18,248.15,1820371.57,12693718.64
35,18,47060000,4300,5136,6175,836,248.15,8584355.493548388,12693718.64
36,21,800000,4307,4344,5959,37,248.15,17091199.984,12693718.64
37,17,93100000,4321,5504,6099,1183,248.15,1614143.0049603174,12693718.64
38,2,570000,4336,4358,6144,22,248.15,2989003.2716499544,12693718.64
39,13,800000,4349,4497,6255,148,248.15,7795654.71978022,12693718.64
40,11,800000,4383,4454,6163,71,248.15,1820371.57,12693718.64
41,2,48200000,4397,4859,6043,462,248.15,2989003.2716499544,12693718.64
42,17,800000,4413,4457,6011,44,248.15,1614143.0049603174,12693718.64
43,3,580000,4440,4498,6260,58,248.15,9246769.549865229,12693718.64
44,2,525000,4457,4506,5974,49,248.15,2989003.2716499544,12693718.64
45,15,88650000,4532,5874,6254,1342,258.28,4522577.48037889,7314077.5
46,15,1120000,4532,5472,6259,940,258.28,4522577.48037889,7314077.5
47,11,828688,4580,4659,6246,79,258.28,1820371.57,7314077.5
48,17,650000,4588,4665,6144,77,258.28,1614143.0049603174,7314077.5
49,12,800000,4590,4622,6213,32,258.28,7658937.101338432,7314077.5
50,7,639000,4600,4617,5967,17,258.28,3738553.685483871,7314077.5
51,17,600000,4600,4618,6093,18,258.28,1614143.0049603174,7314077.5
52,21,92000000,4602,5855,6221,1253,258.28,17091199.984,7314077.5
53,7,1200000,4621,4764,6029,143,258.28,3738553.685483871,7314077.5
54,11,600000,4632,4720,5951,88,258.28,1820371.57,7314077.5
55,13,900000,4637,4751,6170,114,258.28,7795654.71978022,7314077.5
56,19,550000,4692,4791,6060,99,258.28,6721340.5708154505,7314077.5
57,2,700000,4706,4743,6267,37,258.28,2989003.2716499544,7314077.5
58,9,26000000,4707,5468,6123,761,258.28,3707403.8834951455,7314077.5
59,2,775000,4708,4812,5974,104,258.28,2989003.2716499544,7314077.5
60,2,725000,4730,4980,5958,250,258.28,2989003.2716499544,7314077.5
61,2,738144,4735,4772,6256,37,258.28,2989003.2716499544,7314077.5
62,3,600000,4740,4797,6123,57,258.28,9246769.549865229,7314077.5
63,11,1000000,4750,4831,5937,81,258.28,1820371.57,7314077.5
64,2,75000000,4756,5344,6168,588,258.28,2989003.2716499544,7314077.5
65,19,600000,4758,4783,6211,25,258.28,6721340.5708154505,7314077.5
66,11,1600000,4771,4796,6245,25,258.28,1820371.57,7314077.5
67,16,900000,4796,4882,6253,86,258.28,2465023.1840707962,7314077.5
68,15,600000,4799,4819,6186,20,258.28,4522577.48037889,7314077.5
69,12,800000,4807,4813,6008,6,258.28,7658937.101338432,7314077.5
70,15,2500000,4824,4974,6085,150,258.28,4522577.48037889,7314077.5
71,17,850000,4827,5366,6228,539,258.28,1614143.0049603174,7314077.5
72,11,37000000,4827,5308,5982,481,258.28,1820371.57,7314077.5
73,11,785360,4838,5016,5982,178,258.28,1820371.57,7314077.5
74,2,700000,4841,5113,6102,272,253.83,2989003.2716499544,6984378.81
75,14,37765500,4856,5472,6056,616,253.83,5826416.914893617,6984378.81
76,19,700000,4862,4939,5958,77,253.83,6721340.5708154505,6984378.81
77,11,705288,4866,4932,6133,66,253.83,1820371.57,6984378.81
78,2,725000,4882,4944,5968,62,253.83,2989003.2716499544,6984378.81
79,17,630000,4884,4988,6190,104,253.83,1614143.0049603174,6984378.81
80,1,709988,4891,5031,5990,140,253.83,3325419.7044334975,6984378.81
81,11,775000,4901,4996,5975,95,253.83,1820371.57,6984378.81
82,17,552000,4903,5091,5965,188,253.83,1614143.0049603174,6984378.81
83,11,750000,4924,5000,5982,76,253.83,1820371.57,6984378.81
84,4,8000000,4937,5387,6186,450,253.83,4297914.794871795,6984378.81
85,13,800000,4938,5042,6256,104,253.83,7795654.71978022,6984378.81
86,5,3000000,4951,5589,6241,638,253.83,1400922.5020242915,6984378.81
87,18,600000,4958,5118,6101,160,253.83,8584355.493548388,6984378.81
88,2,650000,4960,4996,6268,36,253.83,2989003.2716499544,6984378.81
89,16,650000,4964,5014,6042,50,253.83,2465023.1840707962,6984378.81
90,11,850000,4964,5057,6010,93,253.83,1820371.57,6984378.81
91,5,950000,4965,5163,5990,198,253.83,1400922.5020242915,6984378.81
92,12,1500000,4966,5069,5960,103,253.83,7658937.101338432,6984378.81
93,16,550000,4985,5415,6169,430,253.83,2465023.1840707962,6984378.81
94,2,675000,4995,5098,6270,103,253.83,2989003.2716499544,6984378.81
95,2,700000,5000,5101,6081,101,253.83,2989003.2716499544,6984378.81
96,17,510000,5001,5049,6105,48,253.83,1614143.0049603174,6984378.81
97,16,900000,5002,5080,6121,78,253.83,2465023.1840707962,6984378.81
98,16,900000,5002,5091,6184,89,253.83,2465023.1840707962,6984378.81
99,2,640000,5007,5112,6288,105,253.83,2989003.2716499544,6984378.81
100,18,630920,5013,5084,6017,71,253.83,8584355.493548388,6984378.81
101,2,693496,5017,5121,5955,104,253.83,2989003.2716499544,6984378.81
102,3,1000000,5030,5051,5958,21,253.83,9246769.549865229,6984378.81
103,17,700000,5036,5064,5962,28,253.83,1614143.0049603174,6984378.81
104,2,1000000,5038,5115,6128,77,253.83,2989003.2716499544,6984378.81
105,17,700000,5041,5147,5989,106,253.83,1614143.0049603174,6984378.81
106,11,1000000,5042,5079,6268,37,253.83,1820371.57,6984378.81
107,17,751680,5043,5094,5997,51,253.83,1614143.0049603174,6984378.81
108,15,600000,5063,5324,6283,261,253.83,4522577.48037889,6984378.81
109,11,600000,5077,5097,5982,20,253.83,1820371.57,6984378.81
110,2,544000,5086,5099,6274,13,253.83,2989003.2716499544,6984378.81
111,2,700000,5091,5220,5973,129,253.83,2989003.2716499544,6984378.81
112,12,550000,5091,5177,5960,86,253.83,7658937.101338432,6984378.81
113,2,1300000,5092,5189,5961,97,253.83,2989003.2716499544,6984378.81
114,17,624784,5094,5121,6032,27,253.83,1614143.0049603174,6984378.81
115,11,700000,5111,5127,6001,16,253.83,1820371.57,6984378.81
116,16,600000,5141,5576,6088,435,253.83,2465023.1840707962,6984378.81
117,2,860000,5148,5170,6036,22,253.83,2989003.2716499544,6984378.81
118,12,600000,5150,5167,6127,17,253.83,7658937.101338432,6984378.81
119,12,600000,5150,5246,6011,96,253.83,7658937.101338432,6984378.81
120,18,700000,5154,5182,5944,28,253.83,8584355.493548388,6984378.81
121,3,850000,5156,5206,5975,50,253.83,9246769.549865229,6984378.81
122,17,550000,5167,5303,5951,136,253.83,1614143.0049603174,6984378.81
123,17,550000,5167,5303,5951,136,253.83,1614143.0049603174,6984378.81
124,17,550000,5167,5303,5967,136,253.83,1614143.0049603174,6984378.81
125,1,1200000,5168,5190,6170,22,253.83,3325419.7044334975,6984378.81
126,17,687336,5170,5377,5996,207,253.83,1614143.0049603174,6984378.81
127,12,1000000,5182,5223,6003,41,253.83,7658937.101338432,6984378.81
128,2,650000,5225,5244,6137,19,246.12,2989003.2716499544,6701891.81
129,16,1000000,5234,5252,6037,18,246.12,2465023.1840707962,6701891.81
130,22,795000,5241,5335,6038,94,246.12,2904103.2512077293,6701891.81
131,2,830000,5247,5275,6136,28,246.12,2989003.2716499544,6701891.81
132,2,675000,5254,5274,6053,20,246.12,2989003.2716499544,6701891.81
133,24,2800000,5265,5486,6064,221,246.12,23456062.532786883,6701891.81
134,12,700000,5266,5394,5989,128,246.12,7658937.101338432,6701891.81
135,3,750000,5267,5324,6155,57,246.12,9246769.549865229,6701891.81
136,12,1200000,5269,5463,5996,194,246.12,7658937.101338432,6701891.81
137,16,650000,5269,5310,6072,41,246.12,2465023.1840707962,6701891.81
138,11,850000,5272,5434,5988,162,246.12,1820371.57,6701891.81
139,2,600000,5274,5357,6073,83,246.12,2989003.2716499544,6701891.81
140,2,892990,5287,5426,6246,139,246.12,2989003.2716499544,6701891.81
141,2,675000,5295,5309,6287,14,246.12,2989003.2716499544,6701891.81
142,24,3000000,5296,5359,5986,63,246.12,23456062.532786883,6701891.81
143,12,1000000,5310,5328,6196,18,246.12,7658937.101338432,6701891.81
144,11,850000,5315,5323,6066,8,246.12,1820371.57,6701891.81
145,18,750000,5315,5331,5951,16,246.12,8584355.493548388,6701891.81
146,11,1000000,5323,5329,6252,6,246.12,1820371.57,6701891.81
147,2,1200000,5328,5407,5990,79,246.12,2989003.2716499544,6701891.81
148,17,700000,5328,5372,6142,44,246.12,1614143.0049603174,6701891.81
149,15,700000,5330,5414,6239,84,246.12,4522577.48037889,6701891.81
150,11,1300000,5337,5391,6247,54,246.12,1820371.57,6701891.81
151,15,700000,5349,5409,6098,60,246.12,4522577.48037889,6701891.81
152,12,750000,5350,5379,5974,29,246.12,7658937.101338432,6701891.81
153,2,835000,5357,5364,6112,7,246.12,2989003.2716499544,6701891.81
154,7,650000,5357,5639,6127,282,246.12,3738553.685483871,6701891.81
155,2,540000,5358,5367,6045,9,246.12,2989003.2716499544,6701891.81
156,11,900000,5358,5371,6221,13,246.12,1820371.57,6701891.81
157,2,898000,5358,5379,6107,21,246.12,2989003.2716499544,6701891.81
158,12,1000000,5360,5391,5996,31,246.12,7658937.101338432,6701891.81
159,2,800000,5363,5378,6155,15,246.12,2989003.2716499544,6701891.81
160,2,550000,5364,5381,6203,17,246.12,2989003.2716499544,6701891.81
161,2,650000,5367,5435,5995,68,246.12,2989003.2716499544,6701891.81
162,11,600000,5378,5409,6281,31,246.12,1820371.57,6701891.81
163,2,700000,5379,5420,6081,41,246.12,2989003.2716499544,6701891.81
164,2,858000,5381,5448,5966,67,246.12,2989003.2716499544,6701891.81
165,2,550000,5395,5402,6106,7,246.12,2989003.2716499544,6701891.81
166,17,700000,5401,5450,5958,49,246.12,1614143.0049603174,6701891.81
167,16,520000,5405,5506,6233,101,246.12,2465023.1840707962,6701891.81
168,11,640000,5406,5430,6196,24,246.12,1820371.57,6701891.81
169,19,585000,5414,5471,5975,57,246.12,6721340.5708154505,6701891.81
170,15,550000,5423,5442,5941,19,246.12,4522577.48037889,6701891.81
171,16,900000,5427,5520,6213,93,246.12,2465023.1840707962,6701891.81
172,13,700000,5428,5577,6142,149,246.12,7795654.71978022,6701891.81
173,2,650000,5429,5461,6134,32,246.12,2989003.2716499544,6701891.81
174,18,900000,5435,5486,6105,51,246.12,8584355.493548388,6701891.81
175,11,715000,5437,5468,6105,31,246.12,1820371.57,6701891.81
176,11,666400,5441,5471,6226,30,246.12,1820371.57,6701891.81
177,1,700000,5442,5497,6282,55,246.12,3325419.7044334975,6701891.81
178,2,630000,5450,5464,6092,14,246.12,2989003.2716499544,6701891.81
179,9,650000,5455,5714,6175,259,246.12,3707403.8834951455,6701891.81
180,2,543216,5455,5477,6227,22,246.12,2989003.2716499544,6701891.81
181,16,900000,5457,5485,5973,28,246.12,2465023.1840707962,6701891.81
182,2,600000,5458,5660,6067,202,246.12,2989003.2716499544,6701891.81
183,1,554928,5461,5484,6039,23,246.12,3325419.7044334975,6701891.81
184,2,800000,5464,5484,6024,20,246.12,2989003.2716499544,6701891.81
185,3,800000,5465,5559,6228,94,246.12,9246769.549865229,6701891.81
186,24,2000000,5465,5598,5974,133,246.12,23456062.532786883,6701891.81
187,12,1000000,5465,5493,6009,28,246.12,7658937.101338432,6701891.81
188,16,850000,5471,5483,6254,12,246.12,2465023.1840707962,6701891.81
189,2,655000,5472,5681,6231,209,246.12,2989003.2716499544,6701891.81
190,2,600000,5475,5507,6011,32,246.12,2989003.2716499544,6701891.81
191,11,1200000,5478,5771,5940,293,246.12,1820371.57,6701891.81
192,11,2400000,5478,5771,5960,293,246.12,1820371.57,6701891.81
193,2,600000,5483,5574,6135,91,246.12,2989003.2716499544,6701891.81
194,12,1000000,5491,5528,6052,37,246.12,7658937.101338432,6701891.81
195,17,1000000,5492,5524,6246,32,246.12,1614143.0049603174,6701891.81
196,2,620000,5496,5512,5988,16,246.12,2989003.2716499544,6701891.81
197,16,900000,5497,5531,6044,34,246.12,2465023.1840707962,6701891.81
198,2,625000,5503,5526,6080,23,246.12,2989003.2716499544,6701891.81
199,16,1200000,5504,5603,6291,99,246.12,2465023.1840707962,6701891.81
200,11,850000,5504,5514,6056,10,246.12,1820371.57,6701891.81
201,2,700000,5511,5538,6046,27,246.12,2989003.2716499544,6701891.81
202,17,750000,5512,5527,6008,15,246.12,1614143.0049603174,6701891.81
203,17,658240,5512,5532,6073,20,246.12,1614143.0049603174,6701891.81
204,3,850000,5513,5545,6140,32,246.12,9246769.549865229,6701891.81
205,2,853020,5513,5538,5983,25,246.12,2989003.2716499544,6701891.81
206,2,725000,5514,5527,6164,13,246.12,2989003.2716499544,6701891.81
207,17,712992,5517,5539,6128,22,246.12,1614143.0049603174,6701891.81
208,22,550000,5517,5534,6094,17,246.12,2904103.2512077293,6701891.81
209,17,650000,5519,5616,6253,97,246.12,1614143.0049603174,6701891.81
210,2,700000,5520,5574,6105,54,246.12,2989003.2716499544,6701891.81
211,16,5000000,5521,5617,6245,96,246.12,2465023.1840707962,6701891.81
212,2,700000,5524,5546,6001,22,246.12,2989003.2716499544,6701891.81
213,17,800000,5525,5559,6211,34,246.12,1614143.0049603174,6701891.81
214,11,700000,5531,5547,6015,16,246.12,1820371.57,6701891.81
215,11,850000,5534,5546,6266,12,246.12,1820371.57,6701891.81
216,24,2900000,5542,5575,6102,33,246.12,23456062.532786883,6701891.81
217,2,900000,5542,5555,6211,13,246.12,2989003.2716499544,6701891.81
218,21,1200000,5547,5626,6028,79,246.12,17091199.984,6701891.81
219,8,850000,5554,5624,5982,70,246.12,1501617.2191780822,6701891.81
220,15,700000,5554,5596,6206,42,246.12,4522577.48037889,6701891.81
221,2,700000,5556,5581,6044,25,246.12,2989003.2716499544,6701891.81
222,16,850000,5560,5619,6274,59,246.12,2465023.1840707962,6701891.81
223,17,516384,5574,5612,5975,38,104.75,1614143.0049603174,3369660.19
224,2,700000,5574,5605,6078,31,104.75,2989003.2716499544,3369660.19
225,2,775000,5576,5602,6002,26,104.75,2989003.2716499544,3369660.19
226,12,800000,5577,5597,6289,20,104.75,7658937.101338432,3369660.19
227,11,750000,5583,5623,6035,40,104.75,1820371.57,3369660.19
228,2,633000,5587,5654,6105,67,104.75,2989003.2716499544,3369660.19
229,2,607000,5587,5640,6100,53,104.75,2989003.2716499544,3369660.19
230,2,681000,5591,5596,6009,5,104.75,2989003.2716499544,3369660.19
231,2,609000,5597,5631,6231,34,104.75,2989003.2716499544,3369660.19
232,3,650000,5598,5612,6008,14,104.75,9246769.549865229,3369660.19
233,2,700000,5602,5667,6210,65,104.75,2989003.2716499544,3369660.19
234,11,800000,5604,5636,6206,32,104.75,1820371.57,3369660.19
235,19,600000,5608,5652,6252,44,104.75,6721340.5708154505,3369660.19
236,11,600000,5609,5638,6241,29,104.75,1820371.57,3369660.19
237,2,762000,5610,5699,5975,89,104.75,2989003.2716499544,3369660.19
238,2,770000,5610,5650,6227,40,104.75,2989003.2716499544,3369660.19
239,2,650000,5611,5631,6246,20,104.75,2989003.2716499544,3369660.19
240,18,840000,5616,5659,6088,43,104.75,8584355.493548388,3369660.19
241,17,700000,5618,5640,6051,22,104.75,1614143.0049603174,3369660.19
242,2,825000,5623,5639,6196,16,104.75,2989003.2716499544,3369660.19
243,2,665000,5625,5643,6142,18,104.75,2989003.2716499544,3369660.19
244,18,700000,5630,5660,6207,30,104.75,8584355.493548388,3369660.19
245,2,750000,5632,5659,6035,27,104.75,2989003.2716499544,3369660.19
246,2,760000,5636,5666,5969,30,104.75,2989003.2716499544,3369660.19
247,2,550000,5639,5720,6087,81,104.75,2989003.2716499544,3369660.19
248,24,1000000,5643,5679,6016,36,104.75,23456062.532786883,3369660.19
249,2,615000,5645,5666,6234,21,104.75,2989003.2716499544,3369660.19
250,2,1200000,5653,5659,6296,6,104.75,2989003.2716499544,3369660.19
251,2,800000,5654,5675,6079,21,104.75,2989003.2716499544,3369660.19
252,3,1000000,5654,5689,6262,35,104.75,9246769.549865229,3369660.19
253,18,630000,5659,5703,6267,44,104.75,8584355.493548388,3369660.19
254,11,650000,5667,5682,6226,15,104.75,1820371.57,3369660.19
255,1,606496,5667,5699,6255,32,104.75,3325419.7044334975,3369660.19
256,2,600000,5671,5696,6232,25,104.75,2989003.2716499544,3369660.19
257,2,1000000,5672,5682,6108,10,104.75,2989003.2716499544,3369660.19
258,1,759772,5673,5721,6149,48,104.75,3325419.7044334975,3369660.19
259,16,600000,5675,5703,6262,28,104.75,2465023.1840707962,3369660.19
260,14,600000,5678,5707,6133,29,104.75,5826416.914893617,3369660.19
261,2,565000,5679,5716,6261,37,104.75,2989003.2716499544,3369660.19
262,16,600000,5679,5696,6000,17,104.75,2465023.1840707962,3369660.19
263,2,1200000,5680,5692,6080,12,104.75,2989003.2716499544,3369660.19
264,1,584312,5681,5714,6224,33,104.75,3325419.7044334975,3369660.19
265,2,700000,5685,5727,6128,42,104.75,2989003.2716499544,3369660.19
266,21,2200000,5702,5744,6066,42,104.75,17091199.984,3369660.19
267,17,780102,5702,5745,6099,43,104.75,1614143.0049603174,3369660.19
268,2,630000,5703,5730,6157,27,104.75,2989003.2716499544,3369660.19
269,17,600606,5703,5748,6183,45,104.75,1614143.0049603174,3369660.19
270,2,645000,5706,5723,6281,17,104.75,2989003.2716499544,3369660.19
271,17,800000,5709,5757,6267,48,104.75,1614143.0049603174,3369660.19
272,16,680000,5709,5729,6115,20,104.75,2465023.1840707962,3369660.19
273,12,600000,5710,5749,6102,39,104.75,7658937.101338432,3369660.19
274,21,512000,5714,5756,6067,42,104.75,17091199.984,3369660.19
275,24,1000000,5717,5749,6221,32,104.75,23456062.532786883,3369660.19
276,2,850000,5722,5738,6203,16,104.75,2989003.2716499544,3369660.19
277,2,875000,5723,5735,6165,12,104.75,2989003.2716499544,3369660.19
278,15,600000,5727,5829,6260,102,104.75,4522577.48037889,3369660.19
279,15,600000,5727,5829,6260,102,104.75,4522577.48037889,3369660.19
280,4,600000,5728,5769,6190,41,104.75,4297914.794871795,3369660.19
281,2,633000,5729,5756,6091,27,104.75,2989003.2716499544,3369660.19
282,2,900000,5731,5757,6238,26,104.75,2989003.2716499544,3369660.19
283,17,700000,5735,5770,6214,35,104.75,1614143.0049603174,3369660.19
284,2,800000,5736,5758,6280,22,104.75,2989003.2716499544,3369660.19
285,12,750000,5736,5819,6218,83,104.75,7658937.101338432,3369660.19
286,3,550000,5738,5790,6192,52,104.75,9246769.549865229,3369660.19
287,19,1000000,5742,5757,6199,15,104.75,6721340.5708154505,3369660.19
288,21,1537676,5743,5773,6158,30,104.75,17091199.984,3369660.19
289,2,750000,5751,5763,6189,12,104.75,2989003.2716499544,3369660.19
290,16,570000,5751,5857,6259,106,104.75,2465023.1840707962,3369660.19
291,2,665000,5758,5779,6101,21,104.75,2989003.2716499544,3369660.19
292,16,600000,5762,5806,6212,44,104.75,2465023.1840707962,3369660.19
293,11,522890,5762,5806,6246,44,104.75,1820371.57,3369660.19
294,2,600000,5764,5784,6267,20,104.75,2989003.2716499544,3369660.19
295,2,570000,5769,5814,6254,45,104.75,2989003.2716499544,3369660.19
296,3,1500000,5769,5801,5967,32,104.75,9246769.549865229,3369660.19
297,11,1500000,5771,5785,6191,14,104.75,1820371.57,3369660.19
298,12,1000000,5772,5792,6227,20,104.75,7658937.101338432,3369660.19
299,21,2000000,5773,5897,6252,124,104.75,17091199.984,3369660.19
300,15,900000,5778,5828,6172,50,104.75,4522577.48037889,3369660.19
301,2,600000,5778,5807,6213,29,104.75,2989003.2716499544,3369660.19
302,24,519380,5779,5804,6063,25,104.75,23456062.532786883,3369660.19
303,24,519380,5779,5800,6063,21,104.75,23456062.532786883,3369660.19
304,2,700000,5779,5805,6164,26,104.75,2989003.2716499544,3369660.19
305,2,700000,5790,5814,6273,24,104.75,2989003.2716499544,3369660.19
306,3,550000,5806,5835,5981,29,104.75,9246769.549865229,3369660.19
307,1,673200,5811,5856,6192,45,104.75,3325419.7044334975,3369660.19
308,3,1000000,5812,5822,6252,10,104.75,9246769.549865229,3369660.19
309,12,700000,5813,5826,6287,13,104.75,7658937.101338432,3369660.19
310,17,851508,5825,5920,6266,95,104.75,1614143.0049603174,3369660.19
311,11,730000,5826,5855,6287,29,104.75,1820371.57,3369660.19
312,2,660000,5827,5841,6274,14,104.75,2989003.2716499544,3369660.19
313,2,655000,5828,5882,6144,54,104.75,2989003.2716499544,3369660.19
314,17,575000,5841,5878,6255,37,104.75,1614143.0049603174,3369660.19
315,21,1500000,5843,5881,6066,38,104.75,17091199.984,3369660.19
316,24,3000000,5850,5919,6156,69,104.75,23456062.532786883,3369660.19
317,2,723340,5854,5863,6235,9,104.75,2989003.2716499544,3369660.19
318,21,6000000,5860,5884,6255,24,104.75,17091199.984,3369660.19
319,11,600000,5861,5878,6266,17,104.75,1820371.57,3369660.19
320,4,600000,5863,5891,6248,28,104.75,4297914.794871795,3369660.19
321,15,750000,5867,5888,6290,21,104.75,4522577.48037889,3369660.19
322,11,850000,5870,5892,6259,22,104.75,1820371.57,3369660.19
323,21,1080000,5904,5916,6239,12,104.75,17091199.984,3369660.19
324,15,700000,5924,5951,6280,27,104.75,4522577.48037889,3369660.19
325,5,800000,5925,6014,6259,89,104.75,1400922.5020242915,3369660.19
326,24,1500000,5946,5974,6220,28,141.64,23456062.532786883,5089136.37
327,2,630000,5947,5967,6144,20,141.64,2989003.2716499544,5089136.37
328,17,700000,5958,5994,6280,36,141.64,1614143.0049603174,5089136.37
329,3,800000,5980,6028,6219,48,141.64,9246769.549865229,5089136.37
330,17,1600000,5983,6164,6245,181,141.64,1614143.0049603174,5089136.37
331,12,1000000,6058,6087,6252,29,141.64,7658937.101338432,5089136.37
332,17,735000,6088,6101,6245,13,141.64,1614143.0049603174,5089136.37
333,24,50000000,115,365,,250,184.47,23456062.532786883,9047699.97
334,12,1755000,121,325,,204,184.47,7658937.101338432,9047699.97
335,3,20000000,138,506,,368,184.47,9246769.549865229,9047699.97
336,3,25000000,145,584,,439,184.47,9246769.549865229,9047699.97
337,21,10000000,145,492,,347,184.47,17091199.984,9047699.97
338,11,520000,164,191,,27,184.47,1820371.57,9047699.97
339,12,1000000,169,233,,64,184.47,7658937.101338432,9047699.97
340,21,1500000,226,241,,15,184.47,17091199.984,9047699.97
341,18,1432800,229,298,,69,184.47,8584355.493548388,9047699.97
342,1,1400000,239,354,,115,184.47,3325419.7044334975,9047699.97
343,15,10102000,254,695,,441,184.47,4522577.48037889,9047699.97
344,2,80000000,283,820,,537,184.47,2989003.2716499544,9047699.97
345,21,600000,323,409,,86,184.47,17091199.984,9047699.97
346,21,2000000,348,521,,173,184.47,17091199.984,9047699.97
347,11,590000,361,375,,14,184.47,1820371.57,9047699.97
348,2,24628758,368,534,,166,184.47,2989003.2716499544,9047699.97
349,2,20000000,383,766,,383,184.47,2989003.2716499544,9047699.97
350,24,50000000,439,929,,490,184.47,23456062.532786883,9047699.97
351,11,6000000,458,775,,317,202.94,1820371.57,7117555.88
352,11,1800000,472,610,,138,202.94,1820371.57,7117555.88
353,5,10000000,472,820,,348,202.94,1400922.5020242915,7117555.88
354,3,1000000,484,653,,169,202.94,9246769.549865229,7117555.88
355,15,12918000,505,912,,407,202.94,4522577.48037889,7117555.88
356,17,800000,509,606,,97,202.94,1614143.0049603174,7117555.88
357,17,1300000,522,579,,57,202.94,1614143.0049603174,7117555.88
358,18,3070000,912,1143,,231,140.14,8584355.493548388,7336579.66
359,18,37000000,528,883,,355,202.94,8584355.493548388,7117555.88
360,11,2100000,557,612,,55,202.94,1820371.57,7117555.88
361,24,35000000,586,1123,,537,202.94,23456062.532786883,7117555.88
362,11,1500000,627,920,,293,202.94,1820371.57,7117555.88
363,16,555000,641,690,,49,202.94,2465023.1840707962,7117555.88
364,24,58000000,660,1502,,842,202.94,23456062.532786883,7117555.88
365,24,58000000,660,1502,,842,202.94,23456062.532786883,7117555.88
366,23,1800000,667,939,,272,202.94,5772926.70157068,7117555.88
367,11,524900,669,687,,18,202.94,1820371.57,7117555.88
368,11,600000,674,708,,34,202.94,1820371.57,7117555.88
369,23,1200000,740,757,,17,202.94,5772926.70157068,7117555.88
370,21,3000000,759,1062,,303,202.94,17091199.984,7117555.88
371,11,700000,787,787,,0,202.94,1820371.57,7117555.88
372,1,537000,787,894,,107,202.94,3325419.7044334975,7117555.88
373,3,1500000,857,878,,21,140.14,9246769.549865229,7336579.66
374,21,900000,921,985,,64,140.14,17091199.984,7336579.66
375,15,1300000,1529,1758,,229,219.0,4522577.48037889,7652071.6
376,3,2100000,940,998,,58,140.14,9246769.549865229,7336579.66
377,11,700000,977,997,,20,140.14,1820371.57,7336579.66
378,2,40000000,1039,1332,,293,140.14,2989003.2716499544,7336579.66
379,2,48747810,1048,1625,,577,140.14,2989003.2716499544,7336579.66
380,24,1500000,1058,1271,,213,140.14,23456062.532786883,7336579.66
381,21,22000000,1068,1380,,312,140.14,17091199.984,7336579.66
382,5,30800000,1131,1361,,230,140.14,1400922.5020242915,7336579.66
383,11,900000,1480,1549,,69,219.0,1820371.57,7652071.6
384,19,27000000,1150,1654,,504,140.14,6721340.5708154505,7336579.66
385,3,900000,1172,1348,,176,140.14,9246769.549865229,7336579.66
386,11,23000000,1177,1674,,497,140.14,1820371.57,7336579.66
387,13,12000000,1187,1667,,480,219.0,7795654.71978022,7652071.6
388,15,13810000,1202,1473,,271,219.0,4522577.48037889,7652071.6
389,15,10000000,1202,1465,,263,219.0,4522577.48037889,7652071.6
390,14,1685000,1222,1405,,183,219.0,5826416.914893617,7652071.6
391,15,30000000,1226,1669,,443,219.0,4522577.48037889,7652071.6
392,11,838800,1228,1271,,43,219.0,1820371.57,7652071.6
393,24,6500000,1255,1282,,27,219.0,23456062.532786883,7652071.6
394,13,20000000,1276,1775,,499,219.0,7795654.71978022,7652071.6
395,15,14000000,1276,1821,,545,219.0,4522577.48037889,7652071.6
396,21,1000000,1283,1369,,86,219.0,17091199.984,7652071.6
397,17,555000,1289,1370,,81,219.0,1614143.0049603174,7652071.6
398,1,927740,1289,1300,,11,219.0,3325419.7044334975,7652071.6
399,18,49128000,1289,1671,,382,219.0,8584355.493548388,7652071.6
400,22,12000000,1305,1950,,645,219.0,2904103.2512077293,7652071.6
401,13,600000,1347,1604,,257,219.0,7795654.71978022,7652071.6
402,16,21000000,1359,1936,,577,219.0,2465023.1840707962,7652071.6
403,15,20000000,1376,1768,,392,219.0,4522577.48037889,7652071.6
404,24,30000000,1382,1881,,499,219.0,23456062.532786883,7652071.6
405,11,762000,1384,1682,,298,219.0,1820371.57,7652071.6
406,18,526060,1397,1513,,116,219.0,8584355.493548388,7652071.6
407,16,1253960,1403,1454,,51,219.0,2465023.1840707962,7652071.6
408,2,600000,1404,1423,,19,219.0,2989003.2716499544,7652071.6
409,1,15000000,1431,1703,,272,219.0,3325419.7044334975,7652071.6
410,2,28765000,1452,1790,,338,219.0,2989003.2716499544,7652071.6
411,2,28765000,1452,1790,,338,219.0,2989003.2716499544,7652071.6
412,11,805300,1472,1489,,17,219.0,1820371.57,7652071.6
413,11,631720,1492,1702,,210,219.0,1820371.57,7652071.6
414,11,2500000,1493,1493,,0,219.0,1820371.57,7652071.6
415,4,2200000,1517,1865,,348,219.0,4297914.794871795,7652071.6
416,22,2500000,1521,1880,,359,219.0,2904103.2512077293,7652071.6
417,22,2500000,1522,1880,,358,219.0,2904103.2512077293,7652071.6
418,22,2500000,1522,1880,,358,219.0,2904103.2512077293,7652071.6
419,18,31000000,1542,1976,,434,219.0,8584355.493548388,7652071.6
420,20,10500000,1565,1895,,330,423.81,7597088.421768707,11229609.36
421,20,32000000,1572,3440,,1868,423.81,7597088.421768707,11229609.36
422,24,25000000,1594,2074,,480,423.81,23456062.532786883,11229609.36
423,11,555000,1627,1725,,98,423.81,1820371.57,11229609.36
424,18,600000,1633,1678,,45,423.81,8584355.493548388,11229609.36
425,19,1000000,1636,1773,,137,423.81,6721340.5708154505,11229609.36
426,16,650000,1641,1787,,146,423.81,2465023.1840707962,11229609.36
427,19,2000000,1656,1965,,309,423.81,6721340.5708154505,11229609.36
428,4,600000,1661,1738,,77,423.81,4297914.794871795,11229609.36
429,24,1700000,1747,1766,,19,423.81,23456062.532786883,11229609.36
430,24,30000000,1663,2259,,596,423.81,23456062.532786883,11229609.36
431,20,24000000,1663,2088,,425,423.81,7597088.421768707,11229609.36
432,20,2000000,1669,1970,,301,423.81,7597088.421768707,11229609.36
433,11,600000,1691,1745,,54,423.81,1820371.57,11229609.36
434,15,15000000,1705,2273,,568,423.81,4522577.48037889,11229609.36
435,15,25000000,1706,2131,,425,423.81,4522577.48037889,11229609.36
436,2,64000000,1706,2272,,566,423.81,2989003.2716499544,11229609.36
437,24,12000000,1709,2167,,458,423.81,23456062.532786883,11229609.36
438,22,20000000,1710,2039,,329,423.81,2904103.2512077293,11229609.36
439,11,520000,1738,1793,,55,423.81,1820371.57,11229609.36
440,2,9000000,1739,1961,,222,423.81,2989003.2716499544,11229609.36
441,24,31000000,1753,2095,,342,423.81,23456062.532786883,11229609.36
442,2,18500000,1762,2137,,375,423.81,2989003.2716499544,11229609.36
443,2,6500000,1762,2137,,375,423.81,2989003.2716499544,11229609.36
444,12,18500000,1795,2262,,467,423.81,7658937.101338432,11229609.36
445,15,21000000,1796,2370,,574,423.81,4522577.48037889,11229609.36
446,24,11500000,1811,2257,,446,423.81,23456062.532786883,11229609.36
447,11,525000,1842,1865,,23,423.81,1820371.57,11229609.36
448,24,7500000,1843,1962,,119,423.81,23456062.532786883,11229609.36
449,3,40000000,1845,2122,,277,423.81,9246769.549865229,11229609.36
450,11,2500000,1872,1970,,98,423.81,1820371.57,11229609.36
451,3,35000000,1879,2430,,551,423.81,9246769.549865229,11229609.36
452,4,10000000,1886,2187,,301,423.81,4297914.794871795,11229609.36
453,2,47500000,1886,2265,,379,423.81,2989003.2716499544,11229609.36
454,21,45000000,1891,2425,,534,423.81,17091199.984,11229609.36
455,2,33000000,1892,2271,,379,423.81,2989003.2716499544,11229609.36
456,2,32000000,1894,2271,,377,423.81,2989003.2716499544,11229609.36
457,15,11000000,1894,2370,,476,423.81,4522577.48037889,11229609.36
458,3,65000000,1901,2410,,509,423.81,9246769.549865229,11229609.36
459,13,27000000,1905,2264,,359,423.81,7795654.71978022,11229609.36
460,15,20000000,1906,2271,,365,423.81,4522577.48037889,11229609.36
461,15,20000000,1906,2272,,366,423.81,4522577.48037889,11229609.36
462,24,20000000,1906,2266,,360,423.81,23456062.532786883,11229609.36
463,18,19000000,1908,2263,,355,423.81,8584355.493548388,11229609.36
464,12,35000000,1914,3260,,1346,423.81,7658937.101338432,11229609.36
465,0,2304820,1916,2663,,747,423.81,8418173.322222222,11229609.36
466,0,1975550,1916,2663,,747,423.81,8418173.322222222,11229609.36
467,0,2634060,1916,2663,,747,423.81,8418173.322222222,11229609.36
468,0,2634060,1916,2663,,747,423.81,8418173.322222222,11229609.36
469,0,1975580,1916,2663,,747,423.81,8418173.322222222,11229609.36
470,0,2794700,1916,2663,,747,423.81,8418173.322222222,11229609.36
471,0,2817590,1916,2663,,747,423.81,8418173.322222222,11229609.36
472,0,3330460,1916,2663,,747,423.81,8418173.322222222,11229609.36
473,0,2748820,1916,2663,,747,423.81,8418173.322222222,11229609.36
474,0,2817590,1916,2663,,747,423.81,8418173.322222222,11229609.36
475,13,600000,1916,7381,,5465,423.81,7795654.71978022,11229609.36
476,0,2634060,1916,2663,,747,423.81,8418173.322222222,11229609.36
477,11,40000000,1934,2249,,315,166.1,1820371.57,3498084.51
478,16,600000,1941,2011,,70,166.1,2465023.1840707962,3498084.51
479,12,614000,1961,2019,,58,166.1,7658937.101338432,3498084.51
480,3,700000,1970,2077,,107,166.1,9246769.549865229,3498084.51
481,11,1600000,1970,2007,,37,166.1,1820371.57,3498084.51
482,11,506200,1972,2013,,41,166.1,1820371.57,3498084.51
483,21,15650000,1975,2908,,933,166.1,17091199.984,3498084.51
484,11,526940,1999,2137,,138,166.1,1820371.57,3498084.51
485,17,700000,2004,2014,,10,166.1,1614143.0049603174,3498084.51
486,22,4500000,2014,2242,,228,166.1,2904103.2512077293,3498084.51
487,17,650000,2032,2087,,55,166.1,1614143.0049603174,3498084.51
488,17,750000,2035,2042,,7,166.1,1614143.0049603174,3498084.51
489,24,25000000,2042,2339,,297,166.1,23456062.532786883,3498084.51
490,17,620250,2047,2088,,41,166.1,1614143.0049603174,3498084.51
491,11,942285,2076,2089,,13,166.1,1820371.57,3498084.51
492,21,1000000,2081,2159,,78,166.1,17091199.984,3498084.51
493,17,605000,2087,2122,,35,166.1,1614143.0049603174,3498084.51
494,19,3400000,2089,2152,,63,166.1,6721340.5708154505,3498084.51
495,24,12000000,2090,2984,,894,166.1,23456062.532786883,3498084.51
496,16,750000,2097,2220,,123,166.1,2465023.1840707962,3498084.51
497,24,1000000,2133,2195,,62,166.1,23456062.532786883,3498084.51
498,15,1000001,2181,2819,,638,166.1,4522577.48037889,3498084.51
499,12,550000,2180,2194,,14,166.1,7658937.101338432,3498084.51
500,2,650000,2186,2217,,31,166.1,2989003.2716499544,3498084.51
501,24,5000000,2192,2536,,344,166.1,23456062.532786883,3498084.51
502,11,750000,2208,2258,,50,166.1,1820371.57,3498084.51
503,11,750000,2223,2409,,186,166.1,1820371.57,3498084.51
504,17,750000,2224,2322,,98,166.1,1614143.0049603174,3498084.51
505,11,836610,2269,2318,,49,166.1,1820371.57,3498084.51
506,11,23000000,2271,2699,,428,166.1,1820371.57,3498084.51
507,15,35000000,2272,2826,,554,166.1,4522577.48037889,3498084.51
508,17,570000,2293,2439,,146,230.03,1614143.0049603174,14812242.86
509,5,2943120,2271,2986,,715,166.1,1400922.5020242915,3498084.51
510,5,2173390,2271,2986,,715,166.1,1400922.5020242915,3498084.51
511,5,2943120,2271,2986,,715,166.1,1400922.5020242915,3498084.51
512,15,1500000,2311,2413,,102,230.03,4522577.48037889,14812242.86
513,17,750000,2333,2368,,35,230.03,1614143.0049603174,14812242.86
514,21,1500000,2336,2453,,117,230.03,17091199.984,14812242.86
515,11,700000,2357,2377,,20,230.03,1820371.57,14812242.86
516,17,600000,2374,2395,,21,230.03,1614143.0049603174,14812242.86
517,21,30000000,2378,2935,,557,230.03,17091199.984,14812242.86
518,24,16000000,2383,3001,,618,230.03,23456062.532786883,14812242.86
519,22,600000,2383,2657,,274,230.03,2904103.2512077293,14812242.86
520,11,650000,2389,2403,,14,230.03,1820371.57,14812242.86
521,23,1300000,2389,2434,,45,230.03,5772926.70157068,14812242.86
522,12,750000,2397,2823,,426,230.03,7658937.101338432,14812242.86
523,2,550000,2399,2425,,26,230.03,2989003.2716499544,14812242.86
524,13,540000,2402,2510,,108,230.03,7795654.71978022,14812242.86
525,11,600000,2409,2420,,11,230.03,1820371.57,14812242.86
526,17,550000,2420,2440,,20,230.03,1614143.0049603174,14812242.86
527,11,650000,2424,2476,,52,230.03,1820371.57,14812242.86
528,24,26000000,2441,2851,,410,230.03,23456062.532786883,14812242.86
529,14,550000,2445,2468,,23,230.03,5826416.914893617,14812242.86
530,16,750000,2441,2473,,32,230.03,2465023.1840707962,14812242.86
531,12,35000000,2445,3000,,555,230.03,7658937.101338432,14812242.86
532,17,750000,2453,2462,,9,230.03,1614143.0049603174,14812242.86
533,24,2000000,2455,2571,,116,230.03,23456062.532786883,14812242.86
534,3,700000,2458,2483,,25,230.03,9246769.549865229,14812242.86
535,11,650000,2462,2480,,18,230.03,1820371.57,14812242.86
536,1,8000000,2475,2630,,155,230.03,3325419.7044334975,14812242.86
537,17,600000,2480,2488,,8,230.03,1614143.0049603174,14812242.86
538,24,40000000,2480,3028,,548,230.03,23456062.532786883,14812242.86
539,24,200000000,2481,3281,,800,230.03,23456062.532786883,14812242.86
540,13,25000000,2482,3229,,747,230.03,7795654.71978022,14812242.86
541,17,1000000,2493,2579,,86,230.03,1614143.0049603174,14812242.86
542,11,640000,2515,2565,,50,230.03,1820371.57,14812242.86
543,11,520000,2521,2544,,23,230.03,1820371.57,14812242.86
544,24,180000000,2550,3546,,996,230.03,23456062.532786883,14812242.86
545,24,50000000,2556,3473,,917,230.03,23456062.532786883,14812242.86
546,15,30000000,2573,2881,,308,230.03,4522577.48037889,14812242.86
547,24,100000000,2579,3547,,968,230.03,23456062.532786883,14812242.86
548,2,47500000,2584,2959,,375,230.03,2989003.2716499544,14812242.86
549,24,78000000,2588,3708,,1120,230.03,23456062.532786883,14812242.86
550,3,600000,2605,2626,,21,230.03,9246769.549865229,14812242.86
551,5,600000,2614,2794,,180,230.03,1400922.5020242915,14812242.86
552,23,7000000,2626,3089,,463,230.03,5772926.70157068,14812242.86
553,23,6000000,2626,3545,,919,230.03,5772926.70157068,14812242.86
554,17,950000,2630,2651,,21,230.03,1614143.0049603174,14812242.86
555,11,600000,2633,2662,,29,230.03,1820371.57,14812242.86
556,3,77000000,2636,3764,,1128,230.03,9246769.549865229,14812242.86
557,16,900000,2658,2686,,28,417.96,2465023.1840707962,14954908.92
558,12,800000,2684,2738,,54,417.96,7658937.101338432,14954908.92
559,11,587400,2704,2719,,15,417.96,1820371.57,14954908.92
560,24,700000,2712,2809,,97,417.96,23456062.532786883,14954908.92
561,24,600000,2714,2948,,234,417.96,23456062.532786883,14954908.92
562,17,600000,2714,2759,,45,417.96,1614143.0049603174,14954908.92
563,12,750000,2721,2810,,89,417.96,7658937.101338432,14954908.92
564,12,1000000,2727,2734,,7,417.96,7658937.101338432,14954908.92
565,21,10725000,2731,3707,,976,417.96,17091199.984,14954908.92
566,3,42000000,2732,3742,,1010,417.96,9246769.549865229,14954908.92
567,2,26000000,2734,3364,,630,417.96,2989003.2716499544,14954908.92
568,2,20290000,2734,3364,,630,417.96,2989003.2716499544,14954908.92
569,24,20000000,2734,3895,,1161,417.96,23456062.532786883,14954908.92
570,15,20000000,2734,2994,,260,417.96,4522577.48037889,14954908.92
571,11,552000,2734,2756,,22,417.96,1820371.57,14954908.92
572,24,22000000,2734,3902,,1168,417.96,23456062.532786883,14954908.92
573,11,900000,2734,2858,,124,417.96,1820371.57,14954908.92
574,23,23000000,2735,3299,,564,417.96,5772926.70157068,14954908.92
575,23,1300000,2735,3186,,451,417.96,5772926.70157068,14954908.92
576,20,10500000,2735,3911,,1176,417.96,7597088.421768707,14954908.92
577,5,3500000,2735,3783,,1048,417.96,1400922.5020242915,14954908.92
578,11,926250,2740,2768,,28,417.96,1820371.57,14954908.92
579,13,700000,2766,2797,,31,417.96,7795654.71978022,14954908.92
580,18,24000000,2773,3330,,557,417.96,8584355.493548388,14954908.92
581,11,650000,2794,2811,,17,417.96,1820371.57,14954908.92
582,11,800000,2811,2902,,91,417.96,1820371.57,14954908.92
583,17,550000,2815,2852,,37,417.96,1614143.0049603174,14954908.92
584,15,600000,2822,2839,,17,417.96,4522577.48037889,14954908.92
585,24,75000000,2826,3474,,648,417.96,23456062.532786883,14954908.92
586,24,64500000,2846,3817,,971,417.96,23456062.532786883,14954908.92
587,12,800000,2852,2889,,37,417.96,7658937.101338432,14954908.92
588,11,600000,2854,2872,,18,417.96,1820371.57,14954908.92
589,17,736740,2854,2874,,20,417.96,1614143.0049603174,14954908.92
590,11,799500,2873,2895,,22,417.96,1820371.57,14954908.92
591,12,1000000,2873,3083,,210,417.96,7658937.101338432,14954908.92
592,11,900000,2873,2893,,20,417.96,1820371.57,14954908.92
593,11,1004308,2885,2900,,15,417.96,1820371.57,14954908.92
594,12,22500000,2887,3328,,441,417.96,7658937.101338432,14954908.92
595,24,50000000,2899,4383,,1484,417.96,23456062.532786883,14954908.92
596,24,35000000,2909,4301,,1392,417.96,23456062.532786883,14954908.92
597,12,14800000,2923,3645,,722,417.96,7658937.101338432,14954908.92
598,18,72100000,2923,3713,,790,417.96,8584355.493548388,14954908.92
599,18,37300000,2923,3713,,790,417.96,8584355.493548388,14954908.92
600,17,520000,2928,2943,,15,417.96,1614143.0049603174,14954908.92
601,17,600000,2938,2955,,17,417.96,1614143.0049603174,14954908.92
602,4,2000000,2949,3109,,160,417.96,4297914.794871795,14954908.92
603,13,40000000,2952,3690,,738,417.96,7795654.71978022,14954908.92
604,17,517800,2955,2971,,16,417.96,1614143.0049603174,14954908.92
605,1,641000,2963,2991,,28,417.96,3325419.7044334975,14954908.92
606,1,20500000,2966,3316,,350,417.96,3325419.7044334975,14954908.92
607,3,120000000,2966,3797,,831,417.96,9246769.549865229,14954908.92
608,24,150000000,2977,3890,,913,417.96,23456062.532786883,14954908.92
609,17,649000,2980,3033,,53,417.96,1614143.0049603174,14954908.92
610,12,35000000,2983,3544,,561,417.96,7658937.101338432,14954908.92
611,2,55500000,2992,3951,,959,417.96,2989003.2716499544,14954908.92
612,11,4000000,2993,3077,,84,417.96,1820371.57,14954908.92
613,24,4000000,4048,4127,,79,312.72,23456062.532786883,13350024.59
614,24,2000000,4821,5037,,216,258.28,23456062.532786883,7314077.5
615,17,599000,3000,3021,,21,417.96,1614143.0049603174,14954908.92
616,24,30000000,3001,4516,,1515,417.96,23456062.532786883,14954908.92
617,13,50000000,3004,3749,,745,417.96,7795654.71978022,14954908.92
618,13,2935000,3004,4747,,1743,417.96,7795654.71978022,14954908.92
619,13,50000000,3008,4659,,1651,417.96,7795654.71978022,14954908.92
620,24,40000000,3008,4495,,1487,417.96,23456062.532786883,14954908.92
621,15,26000000,3008,3866,,858,417.96,4522577.48037889,14954908.92
622,11,786155,3011,3084,,73,417.96,1820371.57,14954908.92
623,3,4300000,3054,3867,,813,281.46,9246769.549865229,11503993.02
624,17,1500000,3071,3088,,17,281.46,1614143.0049603174,11503993.02
625,16,550000,3076,3145,,69,281.46,2465023.1840707962,11503993.02
626,1,600000,3077,3099,,22,281.46,3325419.7044334975,11503993.02
627,24,60000000,3084,3817,,733,281.46,23456062.532786883,11503993.02
628,16,38000000,3088,3721,,633,281.46,2465023.1840707962,11503993.02
629,3,750000,3104,3153,,49,281.46,9246769.549865229,11503993.02
630,2,42000000,3104,3901,,797,281.46,2989003.2716499544,11503993.02
631,2,42000000,3104,3901,,797,281.46,2989003.2716499544,11503993.02
632,2,550000,3105,3126,,21,281.46,2989003.2716499544,11503993.02
633,2,550000,3105,3126,,21,281.46,2989003.2716499544,11503993.02
634,18,4860000,3112,3533,,421,281.46,8584355.493548388,11503993.02
635,18,29600000,3113,3482,,369,281.46,8584355.493548388,11503993.02
636,17,620586,3113,3158,,45,281.46,1614143.0049603174,11503993.02
637,18,15100000,3116,3498,,382,281.46,8584355.493548388,11503993.02
638,1,31520000,3117,3370,,253,281.46,3325419.7044334975,11503993.02
639,17,516000,3118,3197,,79,281.46,1614143.0049603174,11503993.02
640,11,581620,3118,3155,,37,281.46,1820371.57,11503993.02
641,17,550000,3120,3138,,18,281.46,1614143.0049603174,11503993.02
642,12,1000000,3127,3167,,40,281.46,7658937.101338432,11503993.02
643,12,800000,3127,3223,,96,281.46,7658937.101338432,11503993.02
644,16,650000,3134,3153,,19,281.46,2465023.1840707962,11503993.02
645,11,650000,3145,3166,,21,281.46,1820371.57,11503993.02
646,11,1000000,3145,3183,,38,281.46,1820371.57,11503993.02
647,15,650000,3146,3176,,30,281.46,4522577.48037889,11503993.02
648,17,1000000,3148,3165,,17,281.46,1614143.0049603174,11503993.02
649,11,600500,3152,3168,,16,281.46,1820371.57,11503993.02
650,3,750000,3153,3176,,23,281.46,9246769.549865229,11503993.02
651,11,1500000,3155,3172,,17,281.46,1820371.57,11503993.02
652,17,1600000,3155,3467,,312,281.46,1614143.0049603174,11503993.02
653,3,53000000,3159,4398,,1239,281.46,9246769.549865229,11503993.02
654,24,38500000,3173,4282,,1109,281.46,23456062.532786883,11503993.02
655,15,700000,3174,3280,,106,281.46,4522577.48037889,11503993.02
656,24,150000000,3175,4237,,1062,281.46,23456062.532786883,11503993.02
657,18,50000000,3176,3949,,773,281.46,8584355.493548388,11503993.02
658,24,30000000,3180,3959,,779,281.46,23456062.532786883,11503993.02
659,17,800000,3181,3197,,16,281.46,1614143.0049603174,11503993.02
660,24,20000000,3187,3785,,598,281.46,23456062.532786883,11503993.02
661,11,2000000,3189,3211,,22,281.46,1820371.57,11503993.02
662,2,596000,3195,3217,,22,281.46,2989003.2716499544,11503993.02
663,16,600000,3197,3244,,47,281.46,2465023.1840707962,11503993.02
664,23,2171000,3202,3760,,558,281.46,5772926.70157068,11503993.02
665,23,2730000,3202,4531,,1329,281.46,5772926.70157068,11503993.02
666,2,750000,3207,3320,,113,281.46,2989003.2716499544,11503993.02
667,18,600000,3207,3225,,18,281.46,8584355.493548388,11503993.02
668,11,850000,3209,3239,,30,281.46,1820371.57,11503993.02
669,11,600000,3210,3210,,0,281.46,1820371.57,11503993.02
670,15,850000,3210,3263,,53,281.46,4522577.48037889,11503993.02
671,20,51000000,3211,4469,,1258,281.46,7597088.421768707,11503993.02
672,16,800000,3225,3246,,21,281.46,2465023.1840707962,11503993.02
673,12,1200000,3225,3246,,21,281.46,7658937.101338432,11503993.02
674,24,7640000,3229,3259,,30,281.46,23456062.532786883,11503993.02
675,2,508000,3229,3258,,29,281.46,2989003.2716499544,11503993.02
676,11,600000,3232,3263,,31,281.46,1820371.57,11503993.02
677,24,20000000,3242,3854,,612,281.46,23456062.532786883,11503993.02
678,11,1000000,3251,3273,,22,281.46,1820371.57,11503993.02
679,17,650000,3266,3280,,14,281.46,1614143.0049603174,11503993.02
680,17,1000000,3266,3295,,29,281.46,1614143.0049603174,11503993.02
681,18,77000000,3270,4939,,1669,281.46,8584355.493548388,11503993.02
682,15,30000000,3273,4380,,1107,281.46,4522577.48037889,11503993.02
683,17,1000000,3274,3292,,18,281.46,1614143.0049603174,11503993.02
684,23,10000000,3285,3858,,573,281.46,5772926.70157068,11503993.02
685,24,30000000,3288,4155,,867,281.46,23456062.532786883,11503993.02
686,11,756000,3292,3391,,99,281.46,1820371.57,11503993.02
687,2,50400000,3300,4462,,1162,281.46,2989003.2716499544,11503993.02
688,2,1500000,3300,4509,,1209,281.46,2989003.2716499544,11503993.02
689,1,600000,3316,3336,,20,281.46,3325419.7044334975,11503993.02
690,11,2100000,3320,3777,,457,281.46,1820371.57,11503993.02
691,18,50000000,3342,3977,,635,281.46,8584355.493548388,11503993.02
692,18,50000000,3342,3977,,635,281.46,8584355.493548388,11503993.02
693,11,750000,3348,3435,,87,281.46,1820371.57,11503993.02
694,24,800000,3349,3368,,19,281.46,23456062.532786883,11503993.02
695,21,13000000,3369,4453,,1084,281.46,17091199.984,11503993.02
696,24,2500000,3406,3407,,1,205.39,23456062.532786883,9006193.27
697,17,600000,3410,3433,,23,205.39,1614143.0049603174,9006193.27
698,24,750000,3412,3453,,41,205.39,23456062.532786883,9006193.27
699,24,56000000,3419,4062,,643,205.39,23456062.532786883,9006193.27
700,23,18000000,3421,4135,,714,205.39,5772926.70157068,9006193.27
701,24,700000,3426,3432,,6,205.39,23456062.532786883,9006193.27
702,21,600000,3438,3533,,95,205.39,17091199.984,9006193.27
703,1,832676,3446,3762,,316,205.39,3325419.7044334975,9006193.27
704,12,10000000,3468,3504,,36,205.39,7658937.101338432,9006193.27
705,11,629564,3481,3523,,42,205.39,1820371.57,9006193.27
706,24,1600000,3491,3552,,61,205.39,23456062.532786883,9006193.27
707,11,650000,3495,3517,,22,205.39,1820371.57,9006193.27
708,11,600000,3509,3526,,17,205.39,1820371.57,9006193.27
709,1,650000,3509,3706,,197,205.39,3325419.7044334975,9006193.27
710,15,950000,3512,3540,,28,205.39,4522577.48037889,9006193.27
711,21,2800000,3518,3879,,361,205.39,17091199.984,9006193.27
712,21,2800000,3518,3879,,361,205.39,17091199.984,9006193.27
713,21,2800000,3518,3817,,299,205.39,17091199.984,9006193.27
714,21,3500000,3518,3734,,216,205.39,17091199.984,9006193.27
715,21,3400000,3524,3734,,210,205.39,17091199.984,9006193.27
716,21,3400000,3524,3734,,210,205.39,17091199.984,9006193.27
717,21,3400000,3524,3734,,210,205.39,17091199.984,9006193.27
718,20,3500000,3525,4041,,516,205.39,7597088.421768707,9006193.27
719,12,1000000,3530,3594,,64,205.39,7658937.101338432,9006193.27
720,12,900000,3530,3610,,80,205.39,7658937.101338432,9006193.27
721,12,900000,3530,3610,,80,205.39,7658937.101338432,9006193.27
722,13,600000,3532,3659,,127,205.39,7795654.71978022,9006193.27
723,2,611186,3546,3630,,84,205.39,2989003.2716499544,9006193.27
724,14,800000,3547,3628,,81,205.39,5826416.914893617,9006193.27
725,21,2500000,3547,3594,,47,205.39,17091199.984,9006193.27
726,17,900000,3593,3610,,17,205.39,1614143.0049603174,9006193.27
727,16,600000,3595,3652,,57,205.39,2465023.1840707962,9006193.27
728,19,650000,3601,3617,,16,205.39,6721340.5708154505,9006193.27
729,13,1200000,3601,3677,,76,205.39,7795654.71978022,9006193.27
730,24,65000000,3603,4168,,565,205.39,23456062.532786883,9006193.27
731,16,550000,3609,3628,,19,205.39,2465023.1840707962,9006193.27
732,3,600000,3613,3707,,94,205.39,9246769.549865229,9006193.27
733,2,541074,3617,3666,,49,205.39,2989003.2716499544,9006193.27
734,24,8000000,3620,4491,,871,205.39,23456062.532786883,9006193.27
735,11,670000,3624,3641,,17,205.39,1820371.57,9006193.27
736,17,1000000,3631,3693,,62,205.39,1614143.0049603174,9006193.27
737,24,145000000,3636,5007,,1371,205.39,23456062.532786883,9006193.27
738,3,700000,3637,3678,,41,205.39,9246769.549865229,9006193.27
739,11,600000,3637,3666,,29,205.39,1820371.57,9006193.27
740,24,1000000,3649,3665,,16,205.39,23456062.532786883,9006193.27
741,17,1000000,3652,3760,,108,205.39,1614143.0049603174,9006193.27
742,24,1700000,3658,3670,,12,205.39,23456062.532786883,9006193.27
743,2,580000,3664,3691,,27,205.39,2989003.2716499544,9006193.27
744,11,2677900,3665,3711,,46,205.39,1820371.57,9006193.27
745,17,680000,3671,3762,,91,205.39,1614143.0049603174,9006193.27
746,17,1000000,3673,3693,,20,205.39,1614143.0049603174,9006193.27
747,15,70000000,3679,4526,,847,205.39,4522577.48037889,9006193.27
748,21,1750000,3680,3715,,35,205.39,17091199.984,9006193.27
749,1,50000000,3684,3988,,304,205.39,3325419.7044334975,9006193.27
750,11,600000,3691,3705,,14,205.39,1820371.57,9006193.27
751,17,794200,3693,3711,,18,205.39,1614143.0049603174,9006193.27
752,17,794200,3693,3711,,18,205.39,1614143.0049603174,9006193.27
753,12,1450000,3697,3980,,283,205.39,7658937.101338432,9006193.27
754,19,578513,3697,3711,,14,205.39,6721340.5708154505,9006193.27
755,24,120000000,3697,4987,,1290,205.39,23456062.532786883,9006193.27
756,21,40000000,3699,4932,,1233,205.39,17091199.984,9006193.27
757,11,1000000,3704,4322,,618,205.39,1820371.57,9006193.27
758,11,1000000,3706,3757,,51,205.39,1820371.57,9006193.27
759,15,1000000,3707,3806,,99,205.39,4522577.48037889,9006193.27
760,24,38000000,3714,4743,,1029,205.39,23456062.532786883,9006193.27
761,24,100000000,3733,4568,,835,205.39,23456062.532786883,9006193.27
762,20,29000000,3734,4686,,952,205.39,7597088.421768707,9006193.27
763,20,30000000,3734,4686,,952,205.39,7597088.421768707,9006193.27
764,17,1500000,3740,3783,,43,205.39,1614143.0049603174,9006193.27
765,15,28000000,3753,4363,,610,312.72,4522577.48037889,13350024.59
766,11,980000,3754,3852,,98,312.72,1820371.57,13350024.59
767,17,1000000,3756,3775,,19,312.72,1614143.0049603174,13350024.59
768,17,1200000,3757,3830,,73,312.72,1614143.0049603174,13350024.59
769,23,20000000,3775,4667,,892,312.72,5772926.70157068,13350024.59
770,21,35000000,3781,4642,,861,312.72,17091199.984,13350024.59
771,17,576000,3781,3841,,60,312.72,1614143.0049603174,13350024.59
772,24,60000000,3782,4519,,737,312.72,23456062.532786883,13350024.59
773,11,1800000,3783,3816,,33,312.72,1820371.57,13350024.59
774,24,122000000,3785,4987,,1202,312.72,23456062.532786883,13350024.59
775,15,4700000,3792,4974,,1182,312.72,4522577.48037889,13350024.59
776,21,30000000,3795,4357,,562,312.72,17091199.984,13350024.59
777,13,20000000,3799,4726,,927,312.72,7795654.71978022,13350024.59
778,17,750000,3802,3826,,24,312.72,1614143.0049603174,13350024.59
779,16,1500000,3802,3858,,56,312.72,2465023.1840707962,13350024.59
780,16,2000000,3818,3907,,89,312.72,2465023.1840707962,13350024.59
781,11,800000,3823,3880,,57,312.72,1820371.57,13350024.59
782,2,149584000,3826,7850,,4024,312.72,2989003.2716499544,13350024.59
783,22,750000,3827,3861,,34,312.72,2904103.2512077293,13350024.59
784,24,65000000,3827,4763,,936,312.72,23456062.532786883,13350024.59
785,24,3800000,4527,4751,,224,258.28,23456062.532786883,7314077.5
786,21,1000000,3827,3867,,40,312.72,17091199.984,13350024.59
787,23,2200000,3830,3928,,98,312.72,5772926.70157068,13350024.59
788,24,25000000,3831,4936,,1105,312.72,23456062.532786883,13350024.59
789,11,600000,3833,3873,,40,312.72,1820371.57,13350024.59
790,2,600000,3838,3879,,41,312.72,2989003.2716499544,13350024.59
791,2,50000000,3839,4308,,469,312.72,2989003.2716499544,13350024.59
792,17,750000,3844,3876,,32,312.72,1614143.0049603174,13350024.59
793,4,750000,3846,3876,,30,312.72,4297914.794871795,13350024.59
794,24,20000000,3854,4152,,298,312.72,23456062.532786883,13350024.59
795,21,800000,3859,3866,,7,312.72,17091199.984,13350024.59
796,20,2100000,3860,4616,,756,312.72,7597088.421768707,13350024.59
797,20,1100000,3860,4513,,653,312.72,7597088.421768707,13350024.59
798,21,1500000,3861,3908,,47,312.72,17091199.984,13350024.59
799,16,1250000,3861,3910,,49,312.72,2465023.1840707962,13350024.59
800,21,547000,3866,3888,,22,312.72,17091199.984,13350024.59
801,1,550000,3868,3902,,34,312.72,3325419.7044334975,13350024.59
802,24,600000,3876,3901,,25,312.72,23456062.532786883,13350024.59
803,1,697000,3880,4034,,154,312.72,3325419.7044334975,13350024.59
804,17,1333601,3881,3953,,72,312.72,1614143.0049603174,13350024.59
805,2,505400,3881,3904,,23,312.72,2989003.2716499544,13350024.59
806,15,1000000,3882,4006,,124,312.72,4522577.48037889,13350024.59
807,15,1000000,3882,4006,,124,312.72,4522577.48037889,13350024.59
808,16,700000,3890,3942,,52,312.72,2465023.1840707962,13350024.59
809,2,646000,3890,3923,,33,312.72,2989003.2716499544,13350024.59
810,16,750000,3901,3938,,37,312.72,2465023.1840707962,13350024.59
811,12,600000,3915,3928,,13,312.72,7658937.101338432,13350024.59
812,24,650000,3916,3938,,22,312.72,23456062.532786883,13350024.59
813,11,800114,3916,3942,,26,312.72,1820371.57,13350024.59
814,12,600000,3918,3967,,49,312.72,7658937.101338432,13350024.59
815,23,770000,3923,3974,,51,312.72,5772926.70157068,13350024.59
816,24,750000,3925,3930,,5,312.72,23456062.532786883,13350024.59
817,16,950000,3931,3987,,56,312.72,2465023.1840707962,13350024.59
818,19,850000,3938,3953,,15,312.72,6721340.5708154505,13350024.59
819,11,750000,3960,3970,,10,312.72,1820371.57,13350024.59
820,1,530000,3964,4181,,217,312.72,3325419.7044334975,13350024.59
821,13,725000,3964,4019,,55,312.72,7795654.71978022,13350024.59
822,12,1500000,3965,4070,,105,312.72,7658937.101338432,13350024.59
823,2,564900,3965,4037,,72,312.72,2989003.2716499544,13350024.59
824,2,541000,3967,3986,,19,312.72,2989003.2716499544,13350024.59
825,2,200000000,3978,5402,,1424,312.72,2989003.2716499544,13350024.59
826,11,2940000,3978,4042,,64,312.72,1820371.57,13350024.59
827,2,600000,3979,4008,,29,312.72,2989003.2716499544,13350024.59
828,2,40000000,3979,4607,,628,312.72,2989003.2716499544,13350024.59
829,11,540230,3981,3999,,18,312.72,1820371.57,13350024.59
830,1,600000,3981,4036,,55,312.72,3325419.7044334975,13350024.59
831,11,3000000,3981,4033,,52,312.72,1820371.57,13350024.59
832,11,637000,3992,4062,,70,312.72,1820371.57,13350024.59
833,24,1200000,3998,4002,,4,312.72,23456062.532786883,13350024.59
834,11,600000,3998,4041,,43,312.72,1820371.57,13350024.59
835,20,550000,4000,4027,,27,312.72,7597088.421768707,13350024.59
836,21,48500000,4005,4965,,960,312.72,17091199.984,13350024.59
837,24,22500000,4012,4611,,599,312.72,23456062.532786883,13350024.59
838,12,40593000,4014,5087,,1073,312.72,7658937.101338432,13350024.59
839,18,63214000,4021,5113,,1092,312.72,8584355.493548388,13350024.59
840,20,11000000,4029,5191,,1162,312.72,7597088.421768707,13350024.59
841,12,800000,4048,4069,,21,312.72,7658937.101338432,13350024.59
842,2,528706,4049,4127,,78,312.72,2989003.2716499544,13350024.59
843,21,1800000,4055,4062,,7,312.72,17091199.984,13350024.59
844,15,600000,4058,4243,,185,312.72,4522577.48037889,13350024.59
845,7,1589296,4058,4378,,320,312.72,3738553.685483871,13350024.59
846,16,1000001,4065,4205,,140,312.72,2465023.1840707962,13350024.59
847,21,15000000,4065,4397,,332,312.72,17091199.984,13350024.59
848,2,950000,4070,4252,,182,312.72,2989003.2716499544,13350024.59
849,12,6000000,4076,4156,,80,312.72,7658937.101338432,13350024.59
850,2,100000000,4079,5401,,1322,312.72,2989003.2716499544,13350024.59
851,3,600000,4083,4084,,1,312.72,9246769.549865229,13350024.59
852,2,825000,4084,4252,,168,312.72,2989003.2716499544,13350024.59
853,2,568000,4090,4126,,36,312.72,2989003.2716499544,13350024.59
854,15,600000,4091,4135,,44,312.72,4522577.48037889,13350024.59
855,15,30000000,4092,4600,,508,312.72,4522577.48037889,13350024.59
856,24,17200000,4092,4490,,398,312.72,23456062.532786883,13350024.59
857,1,523040,4097,4212,,115,312.72,3325419.7044334975,13350024.59
858,3,2400000,4098,4128,,30,312.72,9246769.549865229,13350024.59
859,14,10400000,4099,4163,,64,312.72,5826416.914893617,13350024.59
860,12,55000000,4100,5080,,980,312.72,7658937.101338432,13350024.59
861,11,525000,4111,4497,,386,248.15,1820371.57,12693718.64
862,23,1500000,4111,4120,,9,248.15,5772926.70157068,12693718.64
863,21,65000000,4112,4498,,386,248.15,17091199.984,12693718.64
864,19,25000000,4125,4756,,631,248.15,6721340.5708154505,12693718.64
865,11,800000,4127,4279,,152,248.15,1820371.57,12693718.64
866,11,1155268,4135,4180,,45,248.15,1820371.57,12693718.64
867,17,600000,4139,4181,,42,248.15,1614143.0049603174,12693718.64
868,4,5425000,4145,4503,,358,248.15,4297914.794871795,12693718.64
869,1,2750000,4146,4666,,520,248.15,3325419.7044334975,12693718.64
870,17,707524,4146,4163,,17,248.15,1614143.0049603174,12693718.64
871,16,550000,4160,4238,,78,248.15,2465023.1840707962,12693718.64
872,11,850000,4162,4247,,85,248.15,1820371.57,12693718.64
873,1,583000,4168,4196,,28,248.15,3325419.7044334975,12693718.64
874,11,600000,4173,4194,,21,248.15,1820371.57,12693718.64
875,21,65000000,4177,4671,,494,248.15,17091199.984,12693718.64
876,11,1000000,4182,4201,,19,248.15,1820371.57,12693718.64
877,11,550000,4188,4309,,121,248.15,1820371.57,12693718.64
878,2,550000,4189,4212,,23,248.15,2989003.2716499544,12693718.64
879,11,573116,4189,4257,,68,248.15,1820371.57,12693718.64
880,17,556000,4191,4210,,19,248.15,1614143.0049603174,12693718.64
881,2,1200000,4196,4310,,114,248.15,2989003.2716499544,12693718.64
882,17,760000,4198,4215,,17,248.15,1614143.0049603174,12693718.64
883,12,750000,4198,4303,,105,248.15,7658937.101338432,12693718.64
884,2,550000,4198,4240,,42,248.15,2989003.2716499544,12693718.64
885,23,17000000,4201,4503,,302,248.15,5772926.70157068,12693718.64
886,11,900000,4203,4247,,44,248.15,1820371.57,12693718.64
887,17,750000,4212,4238,,26,248.15,1614143.0049603174,12693718.64
888,22,600000,4215,4233,,18,248.15,2904103.2512077293,12693718.64
889,24,25000000,4218,5741,,1523,248.15,23456062.532786883,12693718.64
890,11,621089,4225,4240,,15,248.15,1820371.57,12693718.64
891,2,631400,4229,4378,,149,248.15,2989003.2716499544,12693718.64
892,1,15000000,4229,4443,,214,248.15,3325419.7044334975,12693718.64
893,2,1000000,4229,4261,,32,248.15,2989003.2716499544,12693718.64
894,1,599000,4230,4236,,6,248.15,3325419.7044334975,12693718.64
895,2,582544,4230,4251,,21,248.15,2989003.2716499544,12693718.64
896,16,54000000,4236,4890,,654,248.15,2465023.1840707962,12693718.64
897,21,1000000,4237,4239,,2,248.15,17091199.984,12693718.64
898,2,525000,4239,4306,,67,248.15,2989003.2716499544,12693718.64
899,4,600000,4240,4261,,21,248.15,4297914.794871795,12693718.64
900,17,3000000,4244,4293,,49,248.15,1614143.0049603174,12693718.64
901,16,850000,4247,4288,,41,248.15,2465023.1840707962,12693718.64
902,2,579824,4261,4281,,20,248.15,2989003.2716499544,12693718.64
903,24,600000,4265,4306,,41,248.15,23456062.532786883,12693718.64
904,23,3200000,4268,4583,,315,248.15,5772926.70157068,12693718.64
905,5,550048,4271,4321,,50,248.15,1400922.5020242915,12693718.64
906,16,1500000,4275,4329,,54,248.15,2465023.1840707962,12693718.64
907,2,550000,4279,4792,,513,248.15,2989003.2716499544,12693718.64
908,2,30000000,4279,5167,,888,248.15,2989003.2716499544,12693718.64
909,15,65000000,4282,5086,,804,248.15,4522577.48037889,12693718.64
910,17,546826,4286,4309,,23,248.15,1614143.0049603174,12693718.64
911,17,585567,4294,4330,,36,248.15,1614143.0049603174,12693718.64
912,2,600520,4299,4323,,24,248.15,2989003.2716499544,12693718.64
913,2,700000,4299,4315,,16,248.15,2989003.2716499544,12693718.64
914,4,11000000,4302,4498,,196,248.15,4297914.794871795,12693718.64
915,4,10000000,4306,4503,,197,248.15,4297914.794871795,12693718.64
916,3,30000000,4308,5353,,1045,248.15,9246769.549865229,12693718.64
917,21,1000000,4310,4316,,6,248.15,17091199.984,12693718.64
918,2,750000,4313,4520,,207,248.15,2989003.2716499544,12693718.64
919,13,80000000,4313,5297,,984,248.15,7795654.71978022,12693718.64
920,11,1000000,4314,4335,,21,248.15,1820371.57,12693718.64
921,2,617116,4322,4371,,49,248.15,2989003.2716499544,12693718.64
922,20,700000,4328,4377,,49,248.15,7597088.421768707,12693718.64
923,13,850000,4329,4343,,14,248.15,7795654.71978022,12693718.64
924,1,575000,4330,4351,,21,248.15,3325419.7044334975,12693718.64
925,1,10000000,4335,4484,,149,248.15,3325419.7044334975,12693718.64
926,24,90000000,4344,4932,,588,248.15,23456062.532786883,12693718.64
927,1,600000,4345,4376,,31,248.15,3325419.7044334975,12693718.64
928,19,750000,4350,4377,,27,248.15,6721340.5708154505,12693718.64
929,2,25000000,4363,5009,,646,248.15,2989003.2716499544,12693718.64
930,1,650000,4363,4427,,64,248.15,3325419.7044334975,12693718.64
931,11,1500000,4364,4397,,33,248.15,1820371.57,12693718.64
932,2,16000000,4364,5009,,645,248.15,2989003.2716499544,12693718.64
933,24,45000000,4366,4989,,623,248.15,23456062.532786883,12693718.64
934,2,718544,4371,4666,,295,248.15,2989003.2716499544,12693718.64
935,11,904264,4371,4404,,33,248.15,1820371.57,12693718.64
936,18,2900000,4373,5171,,798,248.15,8584355.493548388,12693718.64
937,15,600000,4378,4399,,21,248.15,4522577.48037889,12693718.64
938,2,550049,4379,4426,,47,248.15,2989003.2716499544,12693718.64
939,24,12000000,4386,4979,,593,248.15,23456062.532786883,12693718.64
940,2,554000,4386,4404,,18,248.15,2989003.2716499544,12693718.64
941,12,178000000,4393,5924,,1531,248.15,7658937.101338432,12693718.64
942,24,600000,4393,4450,,57,248.15,23456062.532786883,12693718.64
943,16,1500000,4393,4470,,77,248.15,2465023.1840707962,12693718.64
944,23,27000000,4398,4502,,104,248.15,5772926.70157068,12693718.64
945,2,638252,4398,4502,,104,248.15,2989003.2716499544,12693718.64
946,19,650000,4399,4406,,7,248.15,6721340.5708154505,12693718.64
947,15,85000000,4399,5520,,1121,248.15,4522577.48037889,12693718.64
948,2,650360,4400,4510,,110,248.15,2989003.2716499544,12693718.64
949,17,700000,4406,4432,,26,248.15,1614143.0049603174,12693718.64
950,18,750000,4411,4555,,144,248.15,8584355.493548388,12693718.64
951,17,36300000,4413,5230,,817,248.15,1614143.0049603174,12693718.64
952,4,600000,4413,4513,,100,248.15,4297914.794871795,12693718.64
953,20,100000000,4414,5646,,1232,248.15,7597088.421768707,12693718.64
954,1,35000000,4421,4995,,574,248.15,3325419.7044334975,12693718.64
955,1,23000000,4421,4995,,574,248.15,3325419.7044334975,12693718.64
956,2,1500000,4421,4470,,49,248.15,2989003.2716499544,12693718.64
957,11,800000,4428,4461,,33,248.15,1820371.57,12693718.64
958,18,30000000,4429,5332,,903,248.15,8584355.493548388,12693718.64
959,20,15000000,4432,4790,,358,248.15,7597088.421768707,12693718.64
960,17,600000,4434,4447,,13,248.15,1614143.0049603174,12693718.64
961,11,1400000,4439,4524,,85,248.15,1820371.57,12693718.64
962,3,60000000,4442,5133,,691,248.15,9246769.549865229,12693718.64
963,15,11000000,4443,4869,,426,248.15,4522577.48037889,12693718.64
964,2,658080,4447,4533,,86,248.15,2989003.2716499544,12693718.64
965,17,560000,4447,4519,,72,248.15,1614143.0049603174,12693718.64
966,3,25000000,4448,5952,,1504,248.15,9246769.549865229,12693718.64
967,16,4000000,4450,5770,,1320,248.15,2465023.1840707962,12693718.64
968,24,128000000,4454,5680,,1226,248.15,23456062.532786883,12693718.64
969,2,700000,4455,4499,,44,248.15,2989003.2716499544,12693718.64
970,20,8200000,4457,4819,,362,248.15,7597088.421768707,12693718.64
971,24,50000000,4457,5134,,677,248.15,23456062.532786883,12693718.64
972,15,37000000,4457,5136,,679,248.15,4522577.48037889,12693718.64
973,2,700632,4460,4553,,93,248.15,2989003.2716499544,12693718.64
974,17,600000,4462,4482,,20,248.15,1614143.0049603174,12693718.64
975,3,32000000,4462,5195,,733,248.15,9246769.549865229,12693718.64
976,13,12000000,4463,5212,,749,248.15,7795654.71978022,12693718.64
977,15,700000,4464,4698,,234,248.15,4522577.48037889,12693718.64
978,2,600000,4464,4484,,20,248.15,2989003.2716499544,12693718.64
979,15,600000,4470,4513,,43,248.15,4522577.48037889,12693718.64
980,11,720000,4471,4488,,17,248.15,1820371.57,12693718.64
981,1,900000,4475,4534,,59,258.28,3325419.7044334975,7314077.5
982,11,600000,4483,4517,,34,258.28,1820371.57,7314077.5
983,24,33000000,4484,5412,,928,258.28,23456062.532786883,7314077.5
984,2,700000,4489,4595,,106,258.28,2989003.2716499544,7314077.5
985,11,600000,4490,4512,,22,258.28,1820371.57,7314077.5
986,21,600000,4491,4509,,18,258.28,17091199.984,7314077.5
987,21,49970000,4496,5804,,1308,258.28,17091199.984,7314077.5
988,11,1500000,4497,4555,,58,258.28,1820371.57,7314077.5
989,15,600000,4505,4552,,47,258.28,4522577.48037889,7314077.5
990,11,600000,4506,4575,,69,258.28,1820371.57,7314077.5
991,12,750000,4510,4628,,118,258.28,7658937.101338432,7314077.5
992,3,650000,4526,4567,,41,258.28,9246769.549865229,7314077.5
993,17,692460,4530,4555,,25,258.28,1614143.0049603174,7314077.5
994,2,640000,4531,4643,,112,258.28,2989003.2716499544,7314077.5
995,16,800000,4531,4593,,62,258.28,2465023.1840707962,7314077.5
996,12,600000,4531,4555,,24,258.28,7658937.101338432,7314077.5
997,17,700000,4532,4666,,134,258.28,1614143.0049603174,7314077.5
998,1,654472,4533,4595,,62,258.28,3325419.7044334975,7314077.5
999,12,600000,4537,4806,,269,258.28,7658937.101338432,7314077.5
1000,11,948000,4537,4565,,28,258.28,1820371.57,7314077.5
1001,15,10000000,4540,4989,,449,258.28,4522577.48037889,7314077.5
1002,12,550000,4541,4645,,104,258.28,7658937.101338432,7314077.5
1003,12,525000,4541,4645,,104,258.28,7658937.101338432,7314077.5
1004,17,700000,4546,4952,,406,258.28,1614143.0049603174,7314077.5
1005,1,15200000,4548,5678,,1130,258.28,3325419.7044334975,7314077.5
1006,13,25000000,4553,5513,,960,258.28,7795654.71978022,7314077.5
1007,11,660000,4555,4818,,263,258.28,1820371.57,7314077.5
1008,24,6500000,4560,5336,,776,258.28,23456062.532786883,7314077.5
1009,2,600000,4560,4575,,15,258.28,2989003.2716499544,7314077.5
1010,21,25000000,4566,5276,,710,258.28,17091199.984,7314077.5
1011,17,600000,4573,4649,,76,258.28,1614143.0049603174,7314077.5
1012,17,570000,4579,4628,,49,258.28,1614143.0049603174,7314077.5
1013,15,700000,4579,4618,,39,258.28,4522577.48037889,7314077.5
1014,12,1000000,4580,4618,,38,258.28,7658937.101338432,7314077.5
1015,2,550000,4588,4638,,50,258.28,2989003.2716499544,7314077.5
1016,2,600000,4601,4748,,147,258.28,2989003.2716499544,7314077.5
1017,12,1000000,4602,4636,,34,258.28,7658937.101338432,7314077.5
1018,17,549000,4604,4644,,40,258.28,1614143.0049603174,7314077.5
1019,17,600000,4604,4677,,73,258.28,1614143.0049603174,7314077.5
1020,2,565000,4611,5302,,691,258.28,2989003.2716499544,7314077.5
1021,17,600000,4618,4845,,227,258.28,1614143.0049603174,7314077.5
1022,17,1000000,4618,4643,,25,258.28,1614143.0049603174,7314077.5
1023,24,50000000,4621,5391,,770,258.28,23456062.532786883,7314077.5
1024,16,1000000,4621,4686,,65,258.28,2465023.1840707962,7314077.5
1025,18,24000000,4624,5099,,475,258.28,8584355.493548388,7314077.5
1026,17,600000,4624,4868,,244,258.28,1614143.0049603174,7314077.5
1027,1,530000,4629,4716,,87,258.28,3325419.7044334975,7314077.5
1028,2,577776,4631,4743,,112,258.28,2989003.2716499544,7314077.5
1029,1,600000,4632,4666,,34,258.28,3325419.7044334975,7314077.5
1030,4,40000000,4635,5504,,869,258.28,4297914.794871795,7314077.5
1031,2,599200,4642,4897,,255,258.28,2989003.2716499544,7314077.5
1032,11,650000,4643,4681,,38,258.28,1820371.57,7314077.5
1033,2,562912,4649,4770,,121,258.28,2989003.2716499544,7314077.5
1034,10,50899355,4650,5513,,863,258.28,8282326.220930233,7314077.5
1035,12,55000000,4651,5289,,638,258.28,7658937.101338432,7314077.5
1036,11,700000,4657,4751,,94,258.28,1820371.57,7314077.5
1037,17,1000000,4657,4680,,23,258.28,1614143.0049603174,7314077.5
1038,1,555000,4657,4699,,42,258.28,3325419.7044334975,7314077.5
1039,18,97000000,4658,5667,,1009,258.28,8584355.493548388,7314077.5
1040,18,16000000,4658,5667,,1009,258.28,8584355.493548388,7314077.5
1041,2,703400,4660,4761,,101,258.28,2989003.2716499544,7314077.5
1042,11,3600000,4663,4792,,129,258.28,1820371.57,7314077.5
1043,11,600000,4664,4729,,65,258.28,1820371.57,7314077.5
1044,1,623490,4670,4706,,36,258.28,3325419.7044334975,7314077.5
1045,15,650000,4673,4870,,197,258.28,4522577.48037889,7314077.5
1046,18,760000,4674,4709,,35,258.28,8584355.493548388,7314077.5
1047,12,95000000,4680,5672,,992,258.28,7658937.101338432,7314077.5
1048,21,800000,4686,4800,,114,258.28,17091199.984,7314077.5
1049,19,600000,4686,4706,,20,258.28,6721340.5708154505,7314077.5
1050,15,22000000,4687,5189,,502,258.28,4522577.48037889,7314077.5
1051,2,650000,4692,4762,,70,258.28,2989003.2716499544,7314077.5
1052,18,745568,4693,4726,,33,258.28,8584355.493548388,7314077.5
1053,2,600000,4693,4796,,103,258.28,2989003.2716499544,7314077.5
1054,1,604536,4695,4786,,91,258.28,3325419.7044334975,7314077.5
1055,11,1047720,4698,4814,,116,258.28,1820371.57,7314077.5
1056,2,600000,4698,4743,,45,258.28,2989003.2716499544,7314077.5
1057,17,750000,4699,4740,,41,258.28,1614143.0049603174,7314077.5
1058,2,675000,4708,4756,,48,258.28,2989003.2716499544,7314077.5
1059,19,675000,4709,4796,,87,258.28,6721340.5708154505,7314077.5
1060,21,650000,4714,4778,,64,258.28,17091199.984,7314077.5
1061,1,950000,4714,4793,,79,258.28,3325419.7044334975,7314077.5
1062,20,2000000,4728,5233,,505,258.28,7597088.421768707,7314077.5
1063,1,1000000,4730,4791,,61,258.28,3325419.7044334975,7314077.5
1064,2,725000,4730,4980,,250,258.28,2989003.2716499544,7314077.5
1065,12,1500000,4747,4791,,44,258.28,7658937.101338432,7314077.5
1066,17,640000,4747,4961,,214,258.28,1614143.0049603174,7314077.5
1067,12,600000,4749,4792,,43,258.28,7658937.101338432,7314077.5
1068,2,600000,4750,4810,,60,258.28,2989003.2716499544,7314077.5
1069,12,1500000,4750,4842,,92,258.28,7658937.101338432,7314077.5
1070,2,650000,4751,4845,,94,258.28,2989003.2716499544,7314077.5
1071,24,880000,4756,4789,,33,258.28,23456062.532786883,7314077.5
1072,4,700000,4761,4782,,21,258.28,4297914.794871795,7314077.5
1073,17,650000,4765,4792,,27,258.28,1614143.0049603174,7314077.5
1074,3,100000000,4775,5248,,473,258.28,9246769.549865229,7314077.5
1075,15,7500000,4778,4932,,154,258.28,4522577.48037889,7314077.5
1076,2,750000,4779,4860,,81,258.28,2989003.2716499544,7314077.5
1077,11,650000,4779,4814,,35,258.28,1820371.57,7314077.5
1078,2,570000,4782,4820,,38,258.28,2989003.2716499544,7314077.5
1079,1,18000000,4782,5678,,896,258.28,3325419.7044334975,7314077.5
1080,19,600000,4783,4803,,20,258.28,6721340.5708154505,7314077.5
1081,11,1250000,4784,4831,,47,258.28,1820371.57,7314077.5
1082,2,504648,4785,4820,,35,258.28,2989003.2716499544,7314077.5
1083,3,600000,4786,4910,,124,258.28,9246769.549865229,7314077.5
1084,4,10157769,4790,5815,,1025,258.28,4297914.794871795,7314077.5
1085,20,36000000,4799,6644,,1845,258.28,7597088.421768707,7314077.5
1086,3,2000000,4805,4884,,79,258.28,9246769.549865229,7314077.5
1087,17,650000,4806,4905,,99,258.28,1614143.0049603174,7314077.5
1088,11,550000,4807,4909,,102,258.28,1820371.57,7314077.5
1089,11,700000,4810,4869,,59,258.28,1820371.57,7314077.5
1090,11,750000,4810,4869,,59,258.28,1820371.57,7314077.5
1091,24,1500000,4811,4853,,42,258.28,23456062.532786883,7314077.5
1092,3,10000000,4812,6445,,1633,258.28,9246769.549865229,7314077.5
1093,18,614816,4813,4912,,99,258.28,8584355.493548388,7314077.5
1094,11,700000,4813,4828,,15,258.28,1820371.57,7314077.5
1095,24,2000000,4826,4867,,41,258.28,23456062.532786883,7314077.5
1096,11,900000,4826,5175,,349,258.28,1820371.57,7314077.5
1097,20,17000000,4827,5476,,649,258.28,7597088.421768707,7314077.5
1098,16,50000000,4828,5260,,432,258.28,2465023.1840707962,7314077.5
1099,4,1000000,4828,4842,,14,258.28,4297914.794871795,7314077.5
1100,0,46440000,4834,7443,,2609,258.28,8418173.322222222,7314077.5
1101,11,550000,4845,4874,,29,253.83,1820371.57,6984378.81
1102,17,863456,4859,5034,,175,253.83,1614143.0049603174,6984378.81
1103,24,6000000,4859,5455,,596,253.83,23456062.532786883,6984378.81
1104,1,550000,4861,4916,,55,253.83,3325419.7044334975,6984378.81
1105,16,1500000,4862,4939,,77,253.83,2465023.1840707962,6984378.81
1106,10,1700000,4875,4891,,16,253.83,8282326.220930233,6984378.81
1107,15,750000,4880,4953,,73,253.83,4522577.48037889,6984378.81
1108,5,1000000,4880,5073,,193,253.83,1400922.5020242915,6984378.81
1109,10,12000000,4883,5366,,483,253.83,8282326.220930233,6984378.81
1110,17,522924,4883,4915,,32,253.83,1614143.0049603174,6984378.81
1111,15,1000000,4888,4924,,36,253.83,4522577.48037889,6984378.81
1112,16,900000,4897,4960,,63,253.83,2465023.1840707962,6984378.81
1113,17,650000,4897,4930,,33,253.83,1614143.0049603174,6984378.81
1114,23,1800000,4898,5555,,657,253.83,5772926.70157068,6984378.81
1115,6,538500,4902,5022,,120,253.83,1124713.2781954887,6984378.81
1116,17,680000,4904,4992,,88,253.83,1614143.0049603174,6984378.81
1117,16,1250000,4904,4961,,57,253.83,2465023.1840707962,6984378.81
1118,2,685960,4905,4919,,14,253.83,2989003.2716499544,6984378.81
1119,1,799572,4909,4985,,76,253.83,3325419.7044334975,6984378.81
1120,17,505600,4909,5017,,108,253.83,1614143.0049603174,6984378.81
1121,17,1500000,4909,4967,,58,253.83,1614143.0049603174,6984378.81
1122,1,580000,4909,4945,,36,253.83,3325419.7044334975,6984378.81
1123,15,550000,4916,4953,,37,253.83,4522577.48037889,6984378.81
1124,11,1000000,4916,5281,,365,253.83,1820371.57,6984378.81
1125,11,865184,4916,4985,,69,253.83,1820371.57,6984378.81
1126,2,600000,4919,4994,,75,253.83,2989003.2716499544,6984378.81
1127,11,1200000,4919,4972,,53,253.83,1820371.57,6984378.81
1128,11,950000,4922,4985,,63,253.83,1820371.57,6984378.81
1129,17,675000,4924,4961,,37,253.83,1614143.0049603174,6984378.81
1130,11,800000,4930,4985,,55,253.83,1820371.57,6984378.81
1131,2,2500000,4930,4979,,49,253.83,2989003.2716499544,6984378.81
1132,1,550000,4932,4947,,15,253.83,3325419.7044334975,6984378.81
1133,24,250000000,4932,5797,,865,253.83,23456062.532786883,6984378.81
1134,17,625000,4933,5006,,73,253.83,1614143.0049603174,6984378.81
1135,2,600000,4933,5077,,144,253.83,2989003.2716499544,6984378.81
1136,17,1000000,4933,4974,,41,253.83,1614143.0049603174,6984378.81
1137,4,1100000,4937,5590,,653,253.83,4297914.794871795,6984378.81
1138,21,800000,4938,5800,,862,253.83,17091199.984,6984378.81
1139,1,625000,4940,4961,,21,253.83,3325419.7044334975,6984378.81
1140,1,575000,4943,4999,,56,253.83,3325419.7044334975,6984378.81
1141,2,760000,4943,5002,,59,253.83,2989003.2716499544,6984378.81
1142,17,679776,4946,4993,,47,253.83,1614143.0049603174,6984378.81
1143,17,685800,4946,5006,,60,253.83,1614143.0049603174,6984378.81
1144,24,650000,4947,4960,,13,253.83,23456062.532786883,6984378.81
1145,1,700000,4947,5526,,579,253.83,3325419.7044334975,6984378.81
1146,2,700000,4947,5104,,157,253.83,2989003.2716499544,6984378.81
1147,2,16000000,4950,5559,,609,253.83,2989003.2716499544,6984378.81
1148,19,539520,4952,5028,,76,253.83,6721340.5708154505,6984378.81
1149,2,700000,4952,5043,,91,253.83,2989003.2716499544,6984378.81
1150,23,600000,4953,4971,,18,253.83,5772926.70157068,6984378.81
1151,16,600000,4957,5031,,74,253.83,2465023.1840707962,6984378.81
1152,13,700000,4958,4989,,31,253.83,7795654.71978022,6984378.81
1153,1,600000,4961,5042,,81,253.83,3325419.7044334975,6984378.81
1154,11,750000,4964,5345,,381,253.83,1820371.57,6984378.81
1155,2,725000,4965,5003,,38,253.83,2989003.2716499544,6984378.81
1156,15,650000,4966,6042,,1076,253.83,4522577.48037889,6984378.81
1157,16,3000000,4971,5140,,169,253.83,2465023.1840707962,6984378.81
1158,11,725000,4971,4986,,15,253.83,1820371.57,6984378.81
1159,22,700000,4974,5048,,74,253.83,2904103.2512077293,6984378.81
1160,4,2000000,4981,5008,,27,253.83,4297914.794871795,6984378.81
1161,17,618496,4981,5010,,29,253.83,1614143.0049603174,6984378.81
1162,2,550000,4985,5090,,105,253.83,2989003.2716499544,6984378.81
1163,16,850000,4988,5017,,29,253.83,2465023.1840707962,6984378.81
1164,2,700000,4996,5010,,14,253.83,2989003.2716499544,6984378.81
1165,2,700000,4996,5070,,74,253.83,2989003.2716499544,6984378.81
1166,15,700000,4999,5051,,52,253.83,4522577.48037889,6984378.81
1167,16,1000000,5009,5027,,18,253.83,2465023.1840707962,6984378.81
1168,12,1800000,5010,5062,,52,253.83,7658937.101338432,6984378.81
1169,21,800000,5013,5051,,38,253.83,17091199.984,6984378.81
1170,17,523200,5015,5043,,28,253.83,1614143.0049603174,6984378.81
1171,16,1000000,5015,5034,,19,253.83,2465023.1840707962,6984378.81
1172,13,16500000,5017,5665,,648,253.83,7795654.71978022,6984378.81
1173,1,733000,5021,5094,,73,253.83,3325419.7044334975,6984378.81
1174,24,700000,5022,5027,,5,253.83,23456062.532786883,6984378.81
1175,2,810000,5024,5132,,108,253.83,2989003.2716499544,6984378.81
1176,2,800000,5029,5043,,14,253.83,2989003.2716499544,6984378.81
1177,16,900000,5029,5073,,44,253.83,2465023.1840707962,6984378.81
1178,17,2000000,5143,5211,,68,253.83,1614143.0049603174,6984378.81
1179,11,650000,5030,5045,,15,253.83,1820371.57,6984378.81
1180,17,1100004,5031,5052,,21,253.83,1614143.0049603174,6984378.81
1181,11,800000,5036,5070,,34,253.83,1820371.57,6984378.81
1182,1,600000,5037,5077,,40,253.83,3325419.7044334975,6984378.81
1183,17,600000,5038,5070,,32,253.83,1614143.0049603174,6984378.81
1184,1,639000,5044,5122,,78,253.83,3325419.7044334975,6984378.81
1185,11,860000,5048,5118,,70,253.83,1820371.57,6984378.81
1186,16,50000000,5051,5779,,728,253.83,2465023.1840707962,6984378.81
1187,6,600000,5052,5245,,193,253.83,1124713.2781954887,6984378.81
1188,2,630000,5052,5149,,97,253.83,2989003.2716499544,6984378.81
1189,17,550000,5059,5092,,33,253.83,1614143.0049603174,6984378.81
1190,1,951520,5062,5106,,44,253.83,3325419.7044334975,6984378.81
1191,3,950000,5066,5189,,123,253.83,9246769.549865229,6984378.81
1192,12,5000000,5070,5225,,155,253.83,7658937.101338432,6984378.81
1193,12,1000000,5070,5233,,163,253.83,7658937.101338432,6984378.81
1194,12,700000,5076,5098,,22,253.83,7658937.101338432,6984378.81
1195,11,1500000,5079,5190,,111,253.83,1820371.57,6984378.81
1196,22,850000,5079,5205,,126,253.83,2904103.2512077293,6984378.81
1197,12,24446600,5079,5773,,694,253.83,7658937.101338432,6984378.81
1198,12,50000000,5084,7158,,2074,253.83,7658937.101338432,6984378.81
1199,20,1000000,5085,5646,,561,253.83,7597088.421768707,6984378.81
1200,2,680000,5086,5100,,14,253.83,2989003.2716499544,6984378.81
1201,2,670000,5090,5113,,23,253.83,2989003.2716499544,6984378.81
1202,1,700000,5092,5122,,30,253.83,3325419.7044334975,6984378.81
1203,12,2000000,5097,5132,,35,253.83,7658937.101338432,6984378.81
1204,11,570000,5098,5182,,84,253.83,1820371.57,6984378.81
1205,17,850000,5099,5114,,15,253.83,1614143.0049603174,6984378.81
1206,2,600000,5099,5154,,55,253.83,2989003.2716499544,6984378.81
1207,2,750000,5100,5129,,29,253.83,2989003.2716499544,6984378.81
1208,24,58800000,5104,6484,,1380,253.83,23456062.532786883,6984378.81
1209,1,666960,5106,5146,,40,253.83,3325419.7044334975,6984378.81
1210,24,625000,5108,5119,,11,253.83,23456062.532786883,6984378.81
1211,2,850000,5122,5139,,17,253.83,2989003.2716499544,6984378.81
1212,11,1010000,5122,5148,,26,253.83,1820371.57,6984378.81
1213,3,1200000,5127,5175,,48,253.83,9246769.549865229,6984378.81
1214,19,625000,5128,5149,,21,253.83,6721340.5708154505,6984378.81
1215,20,1000000,5132,6424,,1292,253.83,7597088.421768707,6984378.81
1216,20,2000000,5133,6429,,1296,253.83,7597088.421768707,6984378.81
1217,20,2500000,5133,6429,,1296,253.83,7597088.421768707,6984378.81
1218,20,2000000,5133,6429,,1296,253.83,7597088.421768707,6984378.81
1219,20,1500000,5133,6464,,1331,253.83,7597088.421768707,6984378.81
1220,20,1500000,5133,6428,,1295,253.83,7597088.421768707,6984378.81
1221,3,19000000,5133,6179,,1046,253.83,9246769.549865229,6984378.81
1222,19,654400,5134,5141,,7,253.83,6721340.5708154505,6984378.81
1223,17,800000,5134,5154,,20,253.83,1614143.0049603174,6984378.81
1224,12,65000000,5136,8272,,3136,253.83,7658937.101338432,6984378.81
1225,1,539952,5139,5255,,116,253.83,3325419.7044334975,6984378.81
1226,20,60000000,5147,5794,,647,253.83,7597088.421768707,6984378.81
1227,20,30000000,5147,5848,,701,253.83,7597088.421768707,6984378.81
1228,16,850000,5147,5269,,122,253.83,2465023.1840707962,6984378.81
1229,10,600000,5149,5245,,96,253.83,8282326.220930233,6984378.81
1230,17,4300000,5149,6277,,1128,253.83,1614143.0049603174,6984378.81
1231,17,13800000,5149,6234,,1085,253.83,1614143.0049603174,6984378.81
1232,11,760000,5160,5224,,64,253.83,1820371.57,6984378.81
1233,3,75000000,5161,6472,,1311,253.83,9246769.549865229,6984378.81
1234,24,125000000,5164,7033,,1869,253.83,23456062.532786883,6984378.81
1235,20,18000000,5164,6652,,1488,253.83,7597088.421768707,6984378.81
1236,24,800000,5168,5405,,237,253.83,23456062.532786883,6984378.81
1237,16,600000,5170,5199,,29,253.83,2465023.1840707962,6984378.81
1238,1,633644,5174,5262,,88,253.83,3325419.7044334975,6984378.81
1239,3,15000000,5175,5854,,679,253.83,9246769.549865229,6984378.81
1240,2,575000,5183,5224,,41,253.83,2989003.2716499544,6984378.81
1241,24,800000,5188,5288,,100,253.83,23456062.532786883,6984378.81
1242,1,807984,5191,5357,,166,253.83,3325419.7044334975,6984378.81
1243,18,2000000,5223,6302,,1079,246.12,8584355.493548388,6701891.81
1244,16,1750000,5196,6381,,1185,253.83,2465023.1840707962,6984378.81
1245,16,3041920,5196,6381,,1185,253.83,2465023.1840707962,6984378.81
1246,16,2833600,5199,6381,,1182,253.83,2465023.1840707962,6984378.81
1247,16,3105760,5199,6381,,1182,253.83,2465023.1840707962,6984378.81
1248,1,579876,5202,5274,,72,253.83,3325419.7044334975,6984378.81
1249,11,680000,5227,5239,,12,246.12,1820371.57,6701891.81
1250,2,1161000,5230,5588,,358,246.12,2989003.2716499544,6701891.81
1251,15,3422800,5231,6324,,1093,246.12,4522577.48037889,6701891.81
1252,15,3229000,5231,6344,,1113,246.12,4522577.48037889,6701891.81
1253,15,2544000,5231,6352,,1121,246.12,4522577.48037889,6701891.81
1254,15,2544000,5231,6352,,1121,246.12,4522577.48037889,6701891.81
1255,15,2544000,5231,6352,,1121,246.12,4522577.48037889,6701891.81
1256,15,2884000,5231,6347,,1116,246.12,4522577.48037889,6701891.81
1257,15,2884000,5231,6347,,1116,246.12,4522577.48037889,6701891.81
1258,1,850000,5231,5280,,49,246.12,3325419.7044334975,6701891.81
1259,0,2610440,5232,5932,,700,246.12,8418173.322222222,6701891.81
1260,20,10000000,5233,5944,,711,246.12,7597088.421768707,6701891.81
1261,24,80000000,5237,6233,,996,246.12,23456062.532786883,6701891.81
1262,17,1000000,5244,5281,,37,246.12,1614143.0049603174,6701891.81
1263,12,600000,5252,5253,,1,246.12,7658937.101338432,6701891.81
1264,13,1500000,5253,5324,,71,246.12,7795654.71978022,6701891.81
1265,17,850000,5254,5272,,18,246.12,1614143.0049603174,6701891.81
1266,1,600000,5260,5395,,135,246.12,3325419.7044334975,6701891.81
1267,17,550000,5261,5332,,71,246.12,1614143.0049603174,6701891.81
1268,12,600000,5261,5280,,19,246.12,7658937.101338432,6701891.81
1269,16,620000,5265,5302,,37,246.12,2465023.1840707962,6701891.81
1270,17,550000,5268,5282,,14,246.12,1614143.0049603174,6701891.81
1271,11,600000,5268,5300,,32,246.12,1820371.57,6701891.81
1272,24,10200000,5272,6829,,1557,246.12,23456062.532786883,6701891.81
1273,6,600000,5276,5458,,182,246.12,1124713.2781954887,6701891.81
1274,24,3500000,5276,6226,,950,246.12,23456062.532786883,6701891.81
1275,0,600000,5283,5406,,123,246.12,8418173.322222222,6701891.81
1276,17,700000,5296,5317,,21,246.12,1614143.0049603174,6701891.81
1277,12,700000,5297,5331,,34,246.12,7658937.101338432,6701891.81
1278,13,30000000,5307,5939,,632,246.12,7795654.71978022,6701891.81
1279,19,800000,5310,5324,,14,246.12,6721340.5708154505,6701891.81
1280,19,650000,5310,5336,,26,246.12,6721340.5708154505,6701891.81
1281,7,600000,5316,5373,,57,246.12,3738553.685483871,6701891.81
1282,1,23000000,5317,6627,,1310,246.12,3325419.7044334975,6701891.81
1283,16,800000,5322,5374,,52,246.12,2465023.1840707962,6701891.81
1284,4,700000,5325,5399,,74,246.12,4297914.794871795,6701891.81
1285,17,600000,5328,5377,,49,246.12,1614143.0049603174,6701891.81
1286,2,595000,5329,5381,,52,246.12,2989003.2716499544,6701891.81
1287,1,543840,5331,5433,,102,246.12,3325419.7044334975,6701891.81
1288,16,600000,5343,5503,,160,246.12,2465023.1840707962,6701891.81
1289,12,1200000,5344,5394,,50,246.12,7658937.101338432,6701891.81
1290,1,700000,5344,5358,,14,246.12,3325419.7044334975,6701891.81
1291,2,750000,5345,5407,,62,246.12,2989003.2716499544,6701891.81
1292,16,600000,5345,5939,,594,246.12,2465023.1840707962,6701891.81
1293,17,1000000,5346,5378,,32,246.12,1614143.0049603174,6701891.81
1294,24,110000000,5351,6395,,1044,246.12,23456062.532786883,6701891.81
1295,13,700000,5352,5763,,411,246.12,7795654.71978022,6701891.81
1296,16,550000,5357,5374,,17,246.12,2465023.1840707962,6701891.81
1297,17,550000,5358,5391,,33,246.12,1614143.0049603174,6701891.81
1298,23,800000,5358,5387,,29,246.12,5772926.70157068,6701891.81
1299,1,600000,5364,5429,,65,246.12,3325419.7044334975,6701891.81
1300,11,1250000,5364,5388,,24,246.12,1820371.57,6701891.81
1301,1,2000000,5365,5736,,371,246.12,3325419.7044334975,6701891.81
1302,4,600000,5365,5379,,14,246.12,4297914.794871795,6701891.81
1303,18,620000,5366,5407,,41,246.12,8584355.493548388,6701891.81
1304,18,620000,5366,5407,,41,246.12,8584355.493548388,6701891.81
1305,17,1500000,5367,5401,,34,246.12,1614143.0049603174,6701891.81
1306,11,12000000,5369,5924,,555,246.12,1820371.57,6701891.81
1307,2,700000,5370,5465,,95,246.12,2989003.2716499544,6701891.81
1308,17,846000,5371,5433,,62,246.12,1614143.0049603174,6701891.81
1309,17,600000,5374,5395,,21,246.12,1614143.0049603174,6701891.81
1310,21,1196908,5378,5422,,44,246.12,17091199.984,6701891.81
1311,11,700000,5379,5415,,36,246.12,1820371.57,6701891.81
1312,1,635040,5379,5405,,26,246.12,3325419.7044334975,6701891.81
1313,13,750000,5381,5426,,45,246.12,7795654.71978022,6701891.81
1314,17,1200000,5384,5420,,36,246.12,1614143.0049603174,6701891.81
1315,2,530000,5386,5428,,42,246.12,2989003.2716499544,6701891.81
1316,11,1600000,5387,5920,,533,246.12,1820371.57,6701891.81
1317,21,100000000,5392,6325,,933,246.12,17091199.984,6701891.81
1318,11,600000,5393,5451,,58,246.12,1820371.57,6701891.81
1319,15,700000,5395,5435,,40,246.12,4522577.48037889,6701891.81
1320,5,1000000,5395,5422,,27,246.12,1400922.5020242915,6701891.81
1321,16,580000,5398,5464,,66,246.12,2465023.1840707962,6701891.81
1322,17,629744,5399,5427,,28,246.12,1614143.0049603174,6701891.81
1323,1,900000,5412,5433,,21,246.12,3325419.7044334975,6701891.81
1324,3,2200000,5412,5741,,329,246.12,9246769.549865229,6701891.81
1325,11,850000,5413,5434,,21,246.12,1820371.57,6701891.81
1326,16,700000,5413,5507,,94,246.12,2465023.1840707962,6701891.81
1327,17,750000,5420,5436,,16,246.12,1614143.0049603174,6701891.81
1328,22,550000,5422,5442,,20,246.12,2904103.2512077293,6701891.81
1329,1,895000,5422,5433,,11,246.12,3325419.7044334975,6701891.81
1330,11,1000000,5423,5499,,76,246.12,1820371.57,6701891.81
1331,15,1000000,5423,5461,,38,246.12,4522577.48037889,6701891.81
1332,3,2000000,5423,7004,,1581,246.12,9246769.549865229,6701891.81
1333,18,600000,5428,5456,,28,246.12,8584355.493548388,6701891.81
1334,1,900000,5429,5456,,27,246.12,3325419.7044334975,6701891.81
1335,12,600000,5429,5470,,41,246.12,7658937.101338432,6701891.81
1336,11,980000,5433,5441,,8,246.12,1820371.57,6701891.81
1337,18,640000,5435,5597,,162,246.12,8584355.493548388,6701891.81
1338,18,665000,5435,5444,,9,246.12,8584355.493548388,6701891.81
1339,8,600000,5446,5715,,269,246.12,1501617.2191780822,6701891.81
1340,22,8500000,5450,6375,,925,246.12,2904103.2512077293,6701891.81
1341,2,655000,5454,5472,,18,246.12,2989003.2716499544,6701891.81
1342,2,1300000,5461,5475,,14,246.12,2989003.2716499544,6701891.81
1343,11,600000,5462,5485,,23,246.12,1820371.57,6701891.81
1344,4,600000,5463,5500,,37,246.12,4297914.794871795,6701891.81
1345,11,800000,5468,5478,,10,246.12,1820371.57,6701891.81
1346,19,900000,5469,5499,,30,246.12,6721340.5708154505,6701891.81
1347,18,550000,5469,5500,,31,246.12,8584355.493548388,6701891.81
1348,18,600000,5470,5492,,22,246.12,8584355.493548388,6701891.81
1349,18,600000,5470,5492,,22,246.12,8584355.493548388,6701891.81
1350,18,625000,5470,5485,,15,246.12,8584355.493548388,6701891.81
1351,18,750000,5470,5499,,29,246.12,8584355.493548388,6701891.81
1352,18,620000,5470,5545,,75,246.12,8584355.493548388,6701891.81
1353,19,525000,5471,5491,,20,246.12,6721340.5708154505,6701891.81
1354,19,750000,5477,5513,,36,246.12,6721340.5708154505,6701891.81
1355,18,675000,5478,5545,,67,246.12,8584355.493548388,6701891.81
1356,2,610000,5483,5623,,140,246.12,2989003.2716499544,6701891.81
1357,17,800000,5485,5533,,48,246.12,1614143.0049603174,6701891.81
1358,11,895000,5490,5511,,21,246.12,1820371.57,6701891.81
1359,12,70000000,5491,6722,,1231,246.12,7658937.101338432,6701891.81
1360,19,753024,5491,5755,,264,246.12,6721340.5708154505,6701891.81
1361,16,1500000,5497,5682,,185,246.12,2465023.1840707962,6701891.81
1362,16,900000,5497,5512,,15,246.12,2465023.1840707962,6701891.81
1363,17,6850000,5498,6732,,1234,246.12,1614143.0049603174,6701891.81
1364,16,600000,5500,5643,,143,246.12,2465023.1840707962,6701891.81
1365,18,565277,5505,5528,,23,246.12,8584355.493548388,6701891.81
1366,18,565277,5505,5528,,23,246.12,8584355.493548388,6701891.81
1367,18,565277,5505,5528,,23,246.12,8584355.493548388,6701891.81
1368,18,610243,5505,5531,,26,246.12,8584355.493548388,6701891.81
1369,16,800000,5511,5554,,43,246.12,2465023.1840707962,6701891.81
1370,18,65000000,5511,6855,,1344,246.12,8584355.493548388,6701891.81
1371,11,650000,5512,5532,,20,246.12,1820371.57,6701891.81
1372,15,45000000,5513,7355,,1842,246.12,4522577.48037889,6701891.81
1373,18,34000000,5519,6764,,1245,246.12,8584355.493548388,6701891.81
1374,18,2600000,5519,6767,,1248,246.12,8584355.493548388,6701891.81
1375,15,800000,5521,5574,,53,246.12,4522577.48037889,6701891.81
1376,2,16000000,5525,6297,,772,246.12,2989003.2716499544,6701891.81
1377,2,66000000,5525,6289,,764,246.12,2989003.2716499544,6701891.81
1378,3,77256000,5525,6416,,891,246.12,9246769.549865229,6701891.81
1379,9,800000,5526,5541,,15,246.12,3707403.8834951455,6701891.81
1380,21,68000000,5533,6421,,888,246.12,17091199.984,6701891.81
1381,24,131800000,5533,6627,,1094,246.12,23456062.532786883,6701891.81
1382,17,501376,5540,5591,,51,246.12,1614143.0049603174,6701891.81
1383,11,7444000,5542,6466,,924,246.12,1820371.57,6701891.81
1384,11,2500000,5542,6602,,1060,246.12,1820371.57,6701891.81
1385,3,16000000,5542,8067,,2525,246.12,9246769.549865229,6701891.81
1386,18,706421,5545,5589,,44,246.12,8584355.493548388,6701891.81
1387,18,769190,5545,5589,,44,246.12,8584355.493548388,6701891.81
1388,18,3800000,5546,6570,,1024,246.12,8584355.493548388,6701891.81
1389,18,37000000,5546,6570,,1024,246.12,8584355.493548388,6701891.81
1390,10,40000000,5547,6035,,488,246.12,8282326.220930233,6701891.81
1391,15,240000000,5547,7165,,1618,246.12,4522577.48037889,6701891.81
1392,17,10000000,5548,7417,,1869,246.12,1614143.0049603174,6701891.81
1393,17,50000000,5548,7423,,1875,246.12,1614143.0049603174,6701891.81
1394,16,850000,5548,5764,,216,246.12,2465023.1840707962,6701891.81
1395,17,20000000,5548,7418,,1870,246.12,1614143.0049603174,6701891.81
1396,21,34500000,5555,6576,,1021,246.12,17091199.984,6701891.81
1397,24,50000000,5556,7233,,1677,246.12,23456062.532786883,6701891.81
1398,15,12500000,5556,6807,,1251,246.12,4522577.48037889,6701891.81
1399,1,700000,5556,5657,,101,246.12,3325419.7044334975,6701891.81
1400,12,1000000,5559,5617,,58,246.12,7658937.101338432,6701891.81
1401,24,615000,5560,5686,,126,246.12,23456062.532786883,6701891.81
1402,21,42000000,5560,6644,,1084,246.12,17091199.984,6701891.81
1403,21,1000000,5582,5618,,36,104.75,17091199.984,3369660.19
1404,22,800000,5582,5631,,49,104.75,2904103.2512077293,3369660.19
1405,11,900000,5588,5721,,133,104.75,1820371.57,3369660.19
1406,1,543736,5596,5738,,142,104.75,3325419.7044334975,3369660.19
1407,0,1100000,5596,5626,,30,104.75,8418173.322222222,3369660.19
1408,11,750000,5604,5682,,78,104.75,1820371.57,3369660.19
1409,17,900000,5604,5612,,8,104.75,1614143.0049603174,3369660.19
1410,16,800000,5612,5800,,188,104.75,2465023.1840707962,3369660.19
1411,17,562718,5612,5695,,83,104.75,1614143.0049603174,3369660.19
1412,17,742468,5617,5636,,19,104.75,1614143.0049603174,3369660.19
1413,17,650000,5619,5658,,39,104.75,1614143.0049603174,3369660.19
1414,17,664632,5622,5660,,38,104.75,1614143.0049603174,3369660.19
1415,2,550000,5625,5647,,22,104.75,2989003.2716499544,3369660.19
1416,22,1200000,5625,5748,,123,104.75,2904103.2512077293,3369660.19
1417,24,800000,5626,5658,,32,104.75,23456062.532786883,3369660.19
1418,17,1000000,5629,5659,,30,104.75,1614143.0049603174,3369660.19
1419,18,723936,5629,5671,,42,104.75,8584355.493548388,3369660.19
1420,17,8000000,5630,5709,,79,104.75,1614143.0049603174,3369660.19
1421,17,585000,5630,5687,,57,104.75,1614143.0049603174,3369660.19
1422,2,700000,5630,5699,,69,104.75,2989003.2716499544,3369660.19
1423,16,600000,5631,5722,,91,104.75,2465023.1840707962,3369660.19
1424,12,1000000,5631,5682,,51,104.75,7658937.101338432,3369660.19
1425,11,1000000,5632,5643,,11,104.75,1820371.57,3369660.19
1426,11,1000000,5633,5673,,40,104.75,1820371.57,3369660.19
1427,11,630160,5647,5682,,35,104.75,1820371.57,3369660.19
1428,16,750000,5651,5675,,24,104.75,2465023.1840707962,3369660.19
1429,17,700000,5651,5680,,29,104.75,1614143.0049603174,3369660.19
1430,11,600000,5653,5773,,120,104.75,1820371.57,3369660.19
1431,15,650000,5654,5689,,35,104.75,4522577.48037889,3369660.19
1432,11,1380000,5658,8054,,2396,104.75,1820371.57,3369660.19
1433,15,550000,5659,5703,,44,104.75,4522577.48037889,3369660.19
1434,2,550000,5660,5673,,13,104.75,2989003.2716499544,3369660.19
1435,11,1500000,5660,5692,,32,104.75,1820371.57,3369660.19
1436,1,650000,5671,5841,,170,104.75,3325419.7044334975,3369660.19
1437,24,104000000,5671,6750,,1079,104.75,23456062.532786883,3369660.19
1438,1,811300,5679,5722,,43,104.75,3325419.7044334975,3369660.19
1439,17,2200000,5682,5716,,34,104.75,1614143.0049603174,3369660.19
1440,11,730000,5685,5699,,14,104.75,1820371.57,3369660.19
1441,2,800000,5686,5724,,38,104.75,2989003.2716499544,3369660.19
1442,10,11213830,5693,6458,,765,104.75,8282326.220930233,3369660.19
1443,16,700000,5693,5715,,22,104.75,2465023.1840707962,3369660.19
1444,19,1000000,5694,5703,,9,104.75,6721340.5708154505,3369660.19
1445,12,150000000,5696,6917,,1221,104.75,7658937.101338432,3369660.19
1446,6,600000,5699,5870,,171,104.75,1124713.2781954887,3369660.19
1447,6,600000,5699,5870,,171,104.75,1124713.2781954887,3369660.19
1448,6,600000,5699,5870,,171,104.75,1124713.2781954887,3369660.19
1449,6,600000,5699,5870,,171,104.75,1124713.2781954887,3369660.19
1450,6,600000,5699,5870,,171,104.75,1124713.2781954887,3369660.19
1451,6,600000,5699,5870,,171,104.75,1124713.2781954887,3369660.19
1452,6,600000,5699,5870,,171,104.75,1124713.2781954887,3369660.19
1453,6,600000,5699,5878,,179,104.75,1124713.2781954887,3369660.19
1454,6,600000,5699,5870,,171,104.75,1124713.2781954887,3369660.19
1455,6,600000,5699,5871,,172,104.75,1124713.2781954887,3369660.19
1456,6,600000,5699,5870,,171,104.75,1124713.2781954887,3369660.19
1457,6,600000,5699,5878,,179,104.75,1124713.2781954887,3369660.19
1458,6,600000,5699,5878,,179,104.75,1124713.2781954887,3369660.19
1459,6,600000,5699,5878,,179,104.75,1124713.2781954887,3369660.19
1460,6,600000,5699,5878,,179,104.75,1124713.2781954887,3369660.19
1461,6,600000,5699,5878,,179,104.75,1124713.2781954887,3369660.19
1462,6,600000,5699,5870,,171,104.75,1124713.2781954887,3369660.19
1463,6,600000,5699,5870,,171,104.75,1124713.2781954887,3369660.19
1464,6,600000,5699,5870,,171,104.75,1124713.2781954887,3369660.19
1465,6,600000,5699,5878,,179,104.75,1124713.2781954887,3369660.19
1466,16,750000,5700,5729,,29,104.75,2465023.1840707962,3369660.19
1467,17,1000000,5706,5772,,66,104.75,1614143.0049603174,3369660.19
1468,18,725000,5707,5713,,6,104.75,8584355.493548388,3369660.19
1469,18,650000,5708,5779,,71,104.75,8584355.493548388,3369660.19
1470,17,922428,5713,5758,,45,104.75,1614143.0049603174,3369660.19
1471,2,600000,5714,5731,,17,104.75,2989003.2716499544,3369660.19
1472,10,600000,5714,5808,,94,104.75,8282326.220930233,3369660.19
1473,11,1496673,5721,5758,,37,104.75,1820371.57,3369660.19
1474,16,1000000,5722,5764,,42,104.75,2465023.1840707962,3369660.19
1475,15,1000000,5723,6449,,726,104.75,4522577.48037889,3369660.19
1476,12,35000000,5724,6107,,383,104.75,7658937.101338432,3369660.19
1477,15,555000,5730,5765,,35,104.75,4522577.48037889,3369660.19
1478,1,525000,5730,5784,,54,104.75,3325419.7044334975,3369660.19
1479,11,2000000,5734,5748,,14,104.75,1820371.57,3369660.19
1480,2,575000,5734,5745,,11,104.75,2989003.2716499544,3369660.19
1481,15,800000,5735,5771,,36,104.75,4522577.48037889,3369660.19
1482,23,850000,5736,5765,,29,104.75,5772926.70157068,3369660.19
1483,11,885000,5737,5771,,34,104.75,1820371.57,3369660.19
1484,23,1000000,5737,5776,,39,104.75,5772926.70157068,3369660.19
1485,17,1039014,5741,5772,,31,104.75,1614143.0049603174,3369660.19
1486,17,1500000,5744,5792,,48,104.75,1614143.0049603174,3369660.19
1487,24,1200000,5749,5771,,22,104.75,23456062.532786883,3369660.19
1488,11,600000,5749,5778,,29,104.75,1820371.57,3369660.19
1489,17,1750000,5751,5812,,61,104.75,1614143.0049603174,3369660.19
1490,19,3000000,5756,5813,,57,104.75,6721340.5708154505,3369660.19
1491,12,1500000,5758,5791,,33,104.75,7658937.101338432,3369660.19
1492,1,800000,5761,5785,,24,104.75,3325419.7044334975,3369660.19
1493,1,603684,5762,5797,,35,104.75,3325419.7044334975,3369660.19
1494,11,800000,5762,5813,,51,104.75,1820371.57,3369660.19
1495,12,300000000,5764,6941,,1177,104.75,7658937.101338432,3369660.19
1496,17,707400,5764,5784,,20,104.75,1614143.0049603174,3369660.19
1497,16,675000,5765,5785,,20,104.75,2465023.1840707962,3369660.19
1498,12,750000,5770,5812,,42,104.75,7658937.101338432,3369660.19
1499,16,600000,5773,5792,,19,104.75,2465023.1840707962,3369660.19
1500,11,1000000,5773,5843,,70,104.75,1820371.57,3369660.19
1501,16,600000,5773,5806,,33,104.75,2465023.1840707962,3369660.19
1502,2,600000,5776,5892,,116,104.75,2989003.2716499544,3369660.19
1503,12,1200000,5777,5815,,38,104.75,7658937.101338432,3369660.19
1504,2,915000,5777,5797,,20,104.75,2989003.2716499544,3369660.19
1505,12,700000,5778,5792,,14,104.75,7658937.101338432,3369660.19
1506,11,600000,5778,5850,,72,104.75,1820371.57,3369660.19
1507,14,2100000,5778,5857,,79,104.75,5826416.914893617,3369660.19
1508,19,600000,5780,5798,,18,104.75,6721340.5708154505,3369660.19
1509,2,700000,5785,5826,,41,104.75,2989003.2716499544,3369660.19
1510,12,1000000,5787,5808,,21,104.75,7658937.101338432,3369660.19
1511,1,700000,5790,5812,,22,104.75,3325419.7044334975,3369660.19
1512,22,540000,5791,5833,,42,104.75,2904103.2512077293,3369660.19
1513,2,550000,5791,5804,,13,104.75,2989003.2716499544,3369660.19
1514,23,650000,5794,5904,,110,104.75,5772926.70157068,3369660.19
1515,17,800000,5799,5821,,22,104.75,1614143.0049603174,3369660.19
1516,2,700000,5800,5813,,13,104.75,2989003.2716499544,3369660.19
1517,11,975000,5800,5945,,145,104.75,1820371.57,3369660.19
1518,15,600000,5804,5861,,57,104.75,4522577.48037889,3369660.19
1519,7,978000,5806,5982,,176,104.75,3738553.685483871,3369660.19
1520,2,683000,5814,5839,,25,104.75,2989003.2716499544,3369660.19
1521,16,650000,5815,5862,,47,104.75,2465023.1840707962,3369660.19
1522,22,600000,5821,5840,,19,104.75,2904103.2512077293,3369660.19
1523,2,755000,5821,5840,,19,104.75,2989003.2716499544,3369660.19
1524,17,600000,5821,5857,,36,104.75,1614143.0049603174,3369660.19
1525,21,520000,5822,5910,,88,104.75,17091199.984,3369660.19
1526,16,700000,5825,5854,,29,104.75,2465023.1840707962,3369660.19
1527,6,800000,5826,5910,,84,104.75,1124713.2781954887,3369660.19
1528,15,850000,5828,5882,,54,104.75,4522577.48037889,3369660.19
1529,11,700000,5829,6044,,215,104.75,1820371.57,3369660.19
1530,11,750000,5829,5854,,25,104.75,1820371.57,3369660.19
1531,2,800000,5829,5854,,25,104.75,2989003.2716499544,3369660.19
1532,2,800000,5829,5862,,33,104.75,2989003.2716499544,3369660.19
1533,1,600000,5829,5854,,25,104.75,3325419.7044334975,3369660.19
1534,18,16000000,5833,6781,,948,104.75,8584355.493548388,3369660.19
1535,4,65000000,5840,7736,,1896,104.75,4297914.794871795,3369660.19
1536,4,30000000,5842,6781,,939,104.75,4297914.794871795,3369660.19
1537,23,11500000,5847,6059,,212,104.75,5772926.70157068,3369660.19
1538,21,14000000,5848,5909,,61,104.75,17091199.984,3369660.19
1539,17,1000000,5848,5871,,23,104.75,1614143.0049603174,3369660.19
1540,11,750000,5849,5864,,15,104.75,1820371.57,3369660.19
1541,11,1200000,5851,5878,,27,104.75,1820371.57,3369660.19
1542,17,1000000,5854,5892,,38,104.75,1614143.0049603174,3369660.19
1543,16,1000000,5855,5868,,13,104.75,2465023.1840707962,3369660.19
1544,15,600000,5860,5891,,31,104.75,4522577.48037889,3369660.19
1545,13,17600000,5861,6456,,595,104.75,7795654.71978022,3369660.19
1546,2,620000,5861,5902,,41,104.75,2989003.2716499544,3369660.19
1547,17,2000000,5863,6191,,328,104.75,1614143.0049603174,3369660.19
1548,16,800000,5864,5882,,18,104.75,2465023.1840707962,3369660.19
1549,17,700000,5869,5890,,21,104.75,1614143.0049603174,3369660.19
1550,11,700000,5870,5888,,18,104.75,1820371.57,3369660.19
1551,11,800000,5870,5910,,40,104.75,1820371.57,3369660.19
1552,1,600000,5874,5947,,73,104.75,3325419.7044334975,3369660.19
1553,19,640000,5875,5885,,10,104.75,6721340.5708154505,3369660.19
1554,24,130000000,5875,6812,,937,104.75,23456062.532786883,3369660.19
1555,15,600000,5875,5890,,15,104.75,4522577.48037889,3369660.19
1556,17,613280,5882,5947,,65,104.75,1614143.0049603174,3369660.19
1557,17,700000,5884,5898,,14,104.75,1614143.0049603174,3369660.19
1558,21,45000000,5884,7015,,1131,104.75,17091199.984,3369660.19
1559,24,1000000,5884,5888,,4,104.75,23456062.532786883,3369660.19
1560,17,739200,5885,5955,,70,104.75,1614143.0049603174,3369660.19
1561,17,755824,5889,6015,,126,104.75,1614143.0049603174,3369660.19
1562,11,654044,5889,5910,,21,104.75,1820371.57,3369660.19
1563,2,660000,5896,5912,,16,104.75,2989003.2716499544,3369660.19
1564,12,700000,5898,5975,,77,104.75,7658937.101338432,3369660.19
1565,11,1100000,5898,5925,,27,104.75,1820371.57,3369660.19
1566,21,4200000,5898,5975,,77,104.75,17091199.984,3369660.19
1567,5,1500000,5905,5925,,20,104.75,1400922.5020242915,3369660.19
1568,16,650000,5913,5952,,39,104.75,2465023.1840707962,3369660.19
1569,15,550000,5917,5994,,77,104.75,4522577.48037889,3369660.19
1570,11,1000000,5918,5962,,44,104.75,1820371.57,3369660.19
1571,18,44980000,5919,6682,,763,104.75,8584355.493548388,3369660.19
1572,18,8926000,5919,6682,,763,104.75,8584355.493548388,3369660.19
1573,21,140000000,5923,7009,,1086,104.75,17091199.984,3369660.19
1574,17,850000,5924,6007,,83,104.75,1614143.0049603174,3369660.19
1575,15,775000,5924,5960,,36,104.75,4522577.48037889,3369660.19
1576,1,600000,5925,5953,,28,104.75,3325419.7044334975,3369660.19
1577,20,1000000,5925,6115,,190,104.75,7597088.421768707,3369660.19
1578,24,25000000,5926,7893,,1967,104.75,23456062.532786883,3369660.19
1579,6,800000,5938,6039,,101,141.64,1124713.2781954887,5089136.37
1580,6,800000,5938,6037,,99,141.64,1124713.2781954887,5089136.37
1581,19,665000,5941,5969,,28,141.64,6721340.5708154505,5089136.37
1582,23,600000,5941,6693,,752,141.64,5772926.70157068,5089136.37
1583,2,600000,5946,5972,,26,141.64,2989003.2716499544,5089136.37
1584,7,600000,5955,6030,,75,141.64,3738553.685483871,5089136.37
1585,7,616000,5959,6108,,149,141.64,3738553.685483871,5089136.37
1586,7,870000,5966,6045,,79,141.64,3738553.685483871,5089136.37
1587,11,1200000,5969,6002,,33,141.64,1820371.57,5089136.37
1588,3,53000000,5972,6592,,620,141.64,9246769.549865229,5089136.37
1589,2,900000,5973,6050,,77,141.64,2989003.2716499544,5089136.37
1590,19,750000,5974,6022,,48,141.64,6721340.5708154505,5089136.37
1591,7,600000,5976,6308,,332,141.64,3738553.685483871,5089136.37
1592,16,1100000,5976,6556,,580,141.64,2465023.1840707962,5089136.37
1593,15,800000,5980,6014,,34,141.64,4522577.48037889,5089136.37
1594,2,600000,5982,6009,,27,141.64,2989003.2716499544,5089136.37
1595,16,700000,5987,6008,,21,141.64,2465023.1840707962,5089136.37
1596,17,600000,5989,6072,,83,141.64,1614143.0049603174,5089136.37
1597,16,1000000,5990,6015,,25,141.64,2465023.1840707962,5089136.37
1598,13,850000,5990,6043,,53,141.64,7795654.71978022,5089136.37
1599,2,850000,5994,6022,,28,141.64,2989003.2716499544,5089136.37
1600,11,1469000,6001,6057,,56,141.64,1820371.57,5089136.37
1601,17,675000,6002,6921,,919,141.64,1614143.0049603174,5089136.37
1602,3,650000,6003,6101,,98,141.64,9246769.549865229,5089136.37
1603,17,600000,6003,6064,,61,141.64,1614143.0049603174,5089136.37
1604,3,700000,6009,6099,,90,141.64,9246769.549865229,5089136.37
1605,3,540000,6010,6063,,53,141.64,9246769.549865229,5089136.37
1606,3,540000,6010,6046,,36,141.64,9246769.549865229,5089136.37
1607,11,2000000,6010,6045,,35,141.64,1820371.57,5089136.37
1608,11,2500000,6010,6084,,74,141.64,1820371.57,5089136.37
1609,1,800000,6017,6037,,20,141.64,3325419.7044334975,5089136.37
1610,2,750000,6017,6042,,25,141.64,2989003.2716499544,5089136.37
1611,9,613800,6024,6409,,385,141.64,3707403.8834951455,5089136.37
1612,3,1500000,6025,6059,,34,141.64,9246769.549865229,5089136.37
1613,16,3094200,6025,6086,,61,141.64,2465023.1840707962,5089136.37
1614,15,700000,6027,6084,,57,141.64,4522577.48037889,5089136.37
1615,16,760000,6028,6045,,17,141.64,2465023.1840707962,5089136.37
1616,4,1500000,6030,6207,,177,141.64,4297914.794871795,5089136.37
1617,11,1000000,6031,6067,,36,141.64,1820371.57,5089136.37
1618,17,600000,6031,6108,,77,141.64,1614143.0049603174,5089136.37
1619,5,550000,6032,6133,,101,141.64,1400922.5020242915,5089136.37
1620,2,640000,6032,6093,,61,141.64,2989003.2716499544,5089136.37
1621,1,900000,6034,6056,,22,141.64,3325419.7044334975,5089136.37
1622,16,1000000,6038,6056,,18,141.64,2465023.1840707962,5089136.37
1623,1,753800,6038,6084,,46,141.64,3325419.7044334975,5089136.37
1624,17,800000,6039,6053,,14,141.64,1614143.0049603174,5089136.37
1625,13,20000000,6044,6795,,751,141.64,7795654.71978022,5089136.37
1626,13,1300000,6044,6086,,42,141.64,7795654.71978022,5089136.37
1627,17,800000,6044,6093,,49,141.64,1614143.0049603174,5089136.37
1628,1,750000,6049,6087,,38,141.64,3325419.7044334975,5089136.37
1629,19,785000,6049,6074,,25,141.64,6721340.5708154505,5089136.37
1630,1,1100000,6049,6086,,37,141.64,3325419.7044334975,5089136.37
1631,15,600000,6050,6073,,23,141.64,4522577.48037889,5089136.37
1632,4,600000,6050,6066,,16,141.64,4297914.794871795,5089136.37
1633,17,700000,6051,6087,,36,141.64,1614143.0049603174,5089136.37
1634,3,1000000,6051,6136,,85,141.64,9246769.549865229,5089136.37
1635,21,1000000,6051,6081,,30,141.64,17091199.984,5089136.37
1636,17,893400,6053,6081,,28,141.64,1614143.0049603174,5089136.37
1637,4,625000,6058,6079,,21,141.64,4297914.794871795,5089136.37
1638,17,868500,6063,6113,,50,141.64,1614143.0049603174,5089136.37
1639,11,569330,6065,6177,,112,141.64,1820371.57,5089136.37
1640,0,1000000,6071,6751,,680,141.64,8418173.322222222,5089136.37
1641,17,869639,6071,6086,,15,141.64,1614143.0049603174,5089136.37
1642,22,600000,6072,6099,,27,141.64,2904103.2512077293,5089136.37
1643,16,750000,6073,6106,,33,141.64,2465023.1840707962,5089136.37
1644,11,1314215,6078,6106,,28,141.64,1820371.57,5089136.37
1645,17,540800,6078,6098,,20,141.64,1614143.0049603174,5089136.37
1646,2,900000,6078,6121,,43,141.64,2989003.2716499544,5089136.37
1647,18,7032000,6079,6952,,873,141.64,8584355.493548388,5089136.37
1648,18,58900000,6079,6952,,873,141.64,8584355.493548388,5089136.37
1649,11,828635,6080,6282,,202,141.64,1820371.57,5089136.37
1650,19,720680,6080,6106,,26,141.64,6721340.5708154505,5089136.37
1651,12,800000,6080,6119,,39,141.64,7658937.101338432,5089136.37
1652,17,726100,6081,6100,,19,141.64,1614143.0049603174,5089136.37
1653,12,135000000,6085,7005,,920,141.64,7658937.101338432,5089136.37
1654,16,1100000,6085,6101,,16,141.64,2465023.1840707962,5089136.37
1655,17,1095000,6086,6148,,62,141.64,1614143.0049603174,5089136.37
1656,18,45000000,6086,7520,,1434,141.64,8584355.493548388,5089136.37
1657,2,777100,6087,6127,,40,141.64,2989003.2716499544,5089136.37
1658,18,5000000,6088,7528,,1440,141.64,8584355.493548388,5089136.37
1659,16,720000,6093,6106,,13,141.64,2465023.1840707962,5089136.37
1660,16,700000,6093,6106,,13,141.64,2465023.1840707962,5089136.37
1661,17,691080,6098,6135,,37,141.64,1614143.0049603174,5089136.37
1662,17,898380,6100,6135,,35,141.64,1614143.0049603174,5089136.37
1663,22,980000,6102,6136,,34,141.64,2904103.2512077293,5089136.37
1664,2,830000,6108,6133,,25,141.64,2989003.2716499544,5089136.37
1665,15,800000,6112,6134,,22,141.64,4522577.48037889,5089136.37
1666,15,800000,6113,6214,,101,141.64,4522577.48037889,5089136.37
1667,15,800000,6113,6214,,101,141.64,4522577.48037889,5089136.37
1668,17,750000,6120,6155,,35,141.64,1614143.0049603174,5089136.37
1669,24,90000000,6122,6795,,673,141.64,23456062.532786883,5089136.37
1670,11,900000,6123,6158,,35,141.64,1820371.57,5089136.37
1671,17,892150,6123,6169,,46,141.64,1614143.0049603174,5089136.37
1672,11,600000,6129,6149,,20,141.64,1820371.57,5089136.37
1673,17,758000,6130,6162,,32,141.64,1614143.0049603174,5089136.37
1674,1,861000,6135,6205,,70,141.64,3325419.7044334975,5089136.37
1675,11,1705900,6137,6154,,17,141.64,1820371.57,5089136.37
1676,12,780000,6140,6438,,298,141.64,7658937.101338432,5089136.37
1677,11,1107030,6140,6175,,35,141.64,1820371.57,5089136.37
1678,11,801300,6142,6193,,51,141.64,1820371.57,5089136.37
1679,2,800000,6144,6163,,19,141.64,2989003.2716499544,5089136.37
1680,12,91000000,6149,7255,,1106,141.64,7658937.101338432,5089136.37
1681,21,95000000,6151,7786,,1635,141.64,17091199.984,5089136.37
1682,2,650000,6151,6204,,53,141.64,2989003.2716499544,5089136.37
1683,17,700000,6158,6198,,40,141.64,1614143.0049603174,5089136.37
1684,11,1750000,6161,6330,,169,141.64,1820371.57,5089136.37
1685,1,800000,6161,6190,,29,141.64,3325419.7044334975,5089136.37
1686,5,1600000,6162,6177,,15,141.64,1400922.5020242915,5089136.37
1687,11,580500,6163,6235,,72,141.64,1820371.57,5089136.37
1688,11,577945,6163,6186,,23,141.64,1820371.57,5089136.37
1689,2,600000,6164,6241,,77,141.64,2989003.2716499544,5089136.37
1690,22,800000,6168,6205,,37,141.64,2904103.2512077293,5089136.37
1691,15,800000,6169,6205,,36,141.64,4522577.48037889,5089136.37
1692,4,650000,6171,6225,,54,141.64,4297914.794871795,5089136.37
1693,10,800000,6171,6191,,20,141.64,8282326.220930233,5089136.37
1694,15,600000,6171,6192,,21,141.64,4522577.48037889,5089136.37
1695,17,1000000,6175,6191,,16,141.64,1614143.0049603174,5089136.37
1696,17,750000,6179,6210,,31,141.64,1614143.0049603174,5089136.37
1697,17,700000,6179,6344,,165,141.64,1614143.0049603174,5089136.37
1698,17,800000,6179,6213,,34,141.64,1614143.0049603174,5089136.37
1699,17,4600000,6185,7066,,881,141.64,1614143.0049603174,5089136.37
1700,6,704580,6186,6274,,88,141.64,1124713.2781954887,5089136.37
1701,11,760000,6189,6231,,42,141.64,1820371.57,5089136.37
1702,11,700000,6190,6204,,14,141.64,1820371.57,5089136.37
1703,16,650000,6191,6218,,27,141.64,2465023.1840707962,5089136.37
1704,6,750000,6193,6246,,53,141.64,1124713.2781954887,5089136.37
1705,2,855350,6199,6269,,70,141.64,2989003.2716499544,5089136.37
1706,16,2000000,6199,6276,,77,141.64,2465023.1840707962,5089136.37
1707,6,5000000,6200,7698,,1498,141.64,1124713.2781954887,5089136.37
1708,4,1000000,6200,6262,,62,141.64,4297914.794871795,5089136.37
1709,16,900000,6210,6225,,15,141.64,2465023.1840707962,5089136.37
1710,1,1000000,6210,6232,,22,141.64,3325419.7044334975,5089136.37
1711,1,1168070,6218,6256,,38,141.64,3325419.7044334975,5089136.37
1712,2,900000,6219,6289,,70,141.64,2989003.2716499544,5089136.37
1713,11,1000000,6219,6242,,23,141.64,1820371.57,5089136.37
1714,11,5350000,6221,6262,,41,141.64,1820371.57,5089136.37
1715,18,1189500,6224,6379,,155,141.64,8584355.493548388,5089136.37
1716,18,911400,6224,6379,,155,141.64,8584355.493548388,5089136.37
1717,18,913500,6224,6379,,155,141.64,8584355.493548388,5089136.37
1718,18,860700,6224,6379,,155,141.64,8584355.493548388,5089136.37
1719,18,860700,6224,6379,,155,141.64,8584355.493548388,5089136.37
1720,18,1168200,6224,6352,,128,141.64,8584355.493548388,5089136.37
1721,18,1024800,6224,6379,,155,141.64,8584355.493548388,5089136.37
1722,18,915900,6224,6352,,128,141.64,8584355.493548388,5089136.37
1723,18,911400,6224,6352,,128,141.64,8584355.493548388,5089136.37
1724,18,901200,6224,6352,,128,141.64,8584355.493548388,5089136.37
1725,18,913500,6224,6366,,142,141.64,8584355.493548388,5089136.37
1726,18,911400,6225,6352,,127,141.64,8584355.493548388,5089136.37
1727,18,1177500,6225,6352,,127,141.64,8584355.493548388,5089136.37
1728,18,1168200,6225,6352,,127,141.64,8584355.493548388,5089136.37
1729,18,1220700,6225,6352,,127,141.64,8584355.493548388,5089136.37
1730,18,1176600,6225,6352,,127,141.64,8584355.493548388,5089136.37
1731,18,1196700,6225,6379,,154,141.64,8584355.493548388,5089136.37
1732,18,1373700,6225,6379,,154,141.64,8584355.493548388,5089136.37
1733,18,1196700,6225,6379,,154,141.64,8584355.493548388,5089136.37
1734,21,43500000,6225,6918,,693,141.64,17091199.984,5089136.37
1735,2,847135,6226,6247,,21,141.64,2989003.2716499544,5089136.37
1736,15,560000,6227,6564,,337,141.64,4522577.48037889,5089136.37
1737,3,652380,6232,6268,,36,141.64,9246769.549865229,5089136.37
1738,3,1200000,6241,6290,,49,141.64,9246769.549865229,5089136.37
1739,1,600000,6241,6280,,39,141.64,3325419.7044334975,5089136.37
1740,16,570000,6246,6262,,16,141.64,2465023.1840707962,5089136.37
1741,24,10249605,6246,6280,,34,141.64,23456062.532786883,5089136.37
1742,2,1200000,6246,6375,,129,141.64,2989003.2716499544,5089136.37
1743,22,515840,6248,6270,,22,141.64,2904103.2512077293,5089136.37
1744,17,600000,6248,6386,,138,141.64,1614143.0049603174,5089136.37
1745,10,66000000,6248,6914,,666,141.64,8282326.220930233,5089136.37
1746,3,510000,6253,6343,,90,141.64,9246769.549865229,5089136.37
1747,1,625000,6255,6402,,147,141.64,3325419.7044334975,5089136.37
1748,11,3000000,6255,6325,,70,141.64,1820371.57,5089136.37
1749,24,80000000,6260,7120,,860,141.64,23456062.532786883,5089136.37
1750,24,200000000,6261,7893,,1632,141.64,23456062.532786883,5089136.37
1751,1,625000,6262,6402,,140,141.64,3325419.7044334975,5089136.37
1752,1,625000,6262,6402,,140,141.64,3325419.7044334975,5089136.37
1753,1,625000,6262,6402,,140,141.64,3325419.7044334975,5089136.37
1754,1,550000,6262,6422,,160,141.64,3325419.7044334975,5089136.37
1755,1,550000,6262,6422,,160,141.64,3325419.7044334975,5089136.37
1756,1,550000,6262,6422,,160,141.64,3325419.7044334975,5089136.37
1757,1,550000,6262,6422,,160,141.64,3325419.7044334975,5089136.37
1758,1,550000,6262,6422,,160,141.64,3325419.7044334975,5089136.37
1759,1,550000,6262,6422,,160,141.64,3325419.7044334975,5089136.37
1760,1,550000,6262,6422,,160,141.64,3325419.7044334975,5089136.37
1761,1,550000,6262,6422,,160,141.64,3325419.7044334975,5089136.37
1762,1,550000,6262,6526,,264,141.64,3325419.7044334975,5089136.37
1763,1,525000,6262,6526,,264,141.64,3325419.7044334975,5089136.37
1764,1,525000,6262,6526,,264,141.64,3325419.7044334975,5089136.37
1765,4,35000000,6274,7457,,1183,141.64,4297914.794871795,5089136.37
1766,17,603025,6282,6444,,162,141.64,1614143.0049603174,5089136.37
1767,18,10000000,6287,7012,,725,141.64,8584355.493548388,5089136.37
1768,21,60000000,6287,7421,,1134,141.64,17091199.984,5089136.37
1769,2,525300,6289,6506,,217,141.64,2989003.2716499544,5089136.37
1770,2,525300,6289,6648,,359,141.64,2989003.2716499544,5089136.37
1771,2,525300,6289,6648,,359,141.64,2989003.2716499544,5089136.37
1772,2,525300,6289,6652,,363,141.64,2989003.2716499544,5089136.37
1773,2,525300,6289,6506,,217,141.64,2989003.2716499544,5089136.37
1774,2,830840,6289,6409,,120,141.64,2989003.2716499544,5089136.37
1775,22,725000,6290,6331,,41,141.64,2904103.2512077293,5089136.37
1776,18,6500000,6296,6875,,579,141.64,8584355.493548388,5089136.37
1777,18,30000000,6296,6870,,574,141.64,8584355.493548388,5089136.37
1778,5,900000,6296,6445,,149,141.64,1400922.5020242915,5089136.37
1779,11,539310,6296,6330,,34,141.64,1820371.57,5089136.37
1780,15,700000,6297,6326,,29,141.64,4522577.48037889,5089136.37
1781,15,700000,6297,6311,,14,141.64,4522577.48037889,5089136.37
1782,19,29000000,6297,8205,,1908,141.64,6721340.5708154505,5089136.37
1783,19,457000000,6297,8202,,1905,141.64,6721340.5708154505,5089136.37
1784,19,22500000,6297,8216,,1919,141.64,6721340.5708154505,5089136.37
1785,13,15000000,6297,6900,,603,141.64,7795654.71978022,5089136.37
1786,24,6000000,6305,7404,,1099,170.53,23456062.532786883,5237438.95
1787,16,700000,6309,6393,,84,170.53,2465023.1840707962,5237438.95
1788,17,870000,6326,6365,,39,170.53,1614143.0049603174,5237438.95
1789,11,750000,6330,6402,,72,170.53,1820371.57,5237438.95
1790,24,45000000,6332,7061,,729,170.53,23456062.532786883,5237438.95
1791,10,600000,6332,6462,,130,170.53,8282326.220930233,5237438.95
1792,15,600000,6336,6368,,32,170.53,4522577.48037889,5237438.95
1793,19,1000000,6353,6387,,34,170.53,6721340.5708154505,5237438.95
1794,3,600000,6357,6424,,67,170.53,9246769.549865229,5237438.95
1795,17,692900,6359,6385,,26,170.53,1614143.0049603174,5237438.95
1796,2,900000,6361,6470,,109,170.53,2989003.2716499544,5237438.95
1797,21,1000000,6365,6366,,1,170.53,17091199.984,5237438.95
1798,11,5900000,6366,6487,,121,170.53,1820371.57,5237438.95
1799,11,1279500,6366,6413,,47,170.53,1820371.57,5237438.95
1800,10,600000,6371,6448,,77,170.53,8282326.220930233,5237438.95
1801,17,1089535,6371,6438,,67,170.53,1614143.0049603174,5237438.95
1802,11,1000000,6375,6484,,109,170.53,1820371.57,5237438.95
1803,18,1000000,6379,6449,,70,170.53,8584355.493548388,5237438.95
1804,23,48000000,6379,7695,,1316,170.53,5772926.70157068,5237438.95
1805,19,600000,6382,6464,,82,170.53,6721340.5708154505,5237438.95
1806,1,770785,6388,6408,,20,170.53,3325419.7044334975,5237438.95
1807,1,750000,6390,6415,,25,170.53,3325419.7044334975,5237438.95
1808,3,600000,6394,6444,,50,170.53,9246769.549865229,5237438.95
1809,6,600000,6398,6450,,52,170.53,1124713.2781954887,5237438.95
1810,2,874860,6400,6476,,76,170.53,2989003.2716499544,5237438.95
1811,1,650000,6401,6422,,21,170.53,3325419.7044334975,5237438.95
1812,17,975000,6407,6466,,59,170.53,1614143.0049603174,5237438.95
1813,2,700000,6407,6428,,21,170.53,2989003.2716499544,5237438.95
1814,24,90000000,6409,7758,,1349,170.53,23456062.532786883,5237438.95
1815,17,734835,6409,6466,,57,170.53,1614143.0049603174,5237438.95
1816,11,519820,6414,6464,,50,170.53,1820371.57,5237438.95
1817,2,800000,6415,6438,,23,170.53,2989003.2716499544,5237438.95
1818,13,1000000,6415,6445,,30,170.53,7795654.71978022,5237438.95
1819,17,800000,6417,6443,,26,170.53,1614143.0049603174,5237438.95
1820,17,615500,6417,6438,,21,170.53,1614143.0049603174,5237438.95
1821,1,1750000,6420,6435,,15,170.53,3325419.7044334975,5237438.95
1822,16,750000,6421,6442,,21,170.53,2465023.1840707962,5237438.95
1823,12,1000000,6422,6462,,40,170.53,7658937.101338432,5237438.95
1824,17,661780,6422,6484,,62,170.53,1614143.0049603174,5237438.95
1825,17,817085,6427,6445,,18,170.53,1614143.0049603174,5237438.95
1826,12,1000000,6427,6463,,36,170.53,7658937.101338432,5237438.95
1827,2,1090000,6428,6449,,21,170.53,2989003.2716499544,5237438.95
1828,20,30000000,6428,7971,,1543,170.53,7597088.421768707,5237438.95
1829,11,600000,6430,6492,,62,170.53,1820371.57,5237438.95
1830,18,940000,6431,6507,,76,170.53,8584355.493548388,5237438.95
1831,16,700000,6432,6466,,34,170.53,2465023.1840707962,5237438.95
1832,17,1000000,6434,6484,,50,170.53,1614143.0049603174,5237438.95
1833,1,697785,6435,6564,,129,170.53,3325419.7044334975,5237438.95
1834,9,705000,6435,6466,,31,170.53,3707403.8834951455,5237438.95
1835,3,770000,6435,6450,,15,170.53,9246769.549865229,5237438.95
1836,15,5800000,6436,7135,,699,170.53,4522577.48037889,5237438.95
1837,15,5800000,6436,7135,,699,170.53,4522577.48037889,5237438.95
1838,15,5800000,6436,7135,,699,170.53,4522577.48037889,5237438.95
1839,15,1000000,6437,7136,,699,170.53,4522577.48037889,5237438.95
1840,2,882850,6437,6953,,516,170.53,2989003.2716499544,5237438.95
1841,4,600000,6437,6564,,127,170.53,4297914.794871795,5237438.95
1842,1,2000000,6437,6476,,39,170.53,3325419.7044334975,5237438.95
1843,2,1200000,6438,6527,,89,170.53,2989003.2716499544,5237438.95
1844,17,600000,6438,6484,,46,170.53,1614143.0049603174,5237438.95
1845,2,840115,6442,6535,,93,170.53,2989003.2716499544,5237438.95
1846,7,1000000,6443,6848,,405,170.53,3738553.685483871,5237438.95
1847,16,2000000,6445,6476,,31,170.53,2465023.1840707962,5237438.95
1848,12,525000,6448,6465,,17,170.53,7658937.101338432,5237438.95
1849,16,570000,6449,6470,,21,170.53,2465023.1840707962,5237438.95
1850,23,170000000,6450,7591,,1141,170.53,5772926.70157068,5237438.95
1851,13,650000,6452,6506,,54,170.53,7795654.71978022,5237438.95
1852,4,1000000,6452,6504,,52,170.53,4297914.794871795,5237438.95
1853,3,750000,6455,6479,,24,170.53,9246769.549865229,5237438.95
1854,3,750000,6456,6486,,30,170.53,9246769.549865229,5237438.95
1855,17,600000,6457,6499,,42,170.53,1614143.0049603174,5237438.95
1856,17,1000000,6458,6514,,56,170.53,1614143.0049603174,5237438.95
1857,21,1000000,6458,6485,,27,170.53,17091199.984,5237438.95
1858,17,950000,6459,6486,,27,170.53,1614143.0049603174,5237438.95
1859,2,650000,6462,6540,,78,170.53,2989003.2716499544,5237438.95
1860,18,1100000,6462,6798,,336,170.53,8584355.493548388,5237438.95
1861,14,620000,6462,6521,,59,170.53,5826416.914893617,5237438.95
1862,15,550000,6462,6514,,52,170.53,4522577.48037889,5237438.95
1863,0,800000,6464,6494,,30,170.53,8418173.322222222,5237438.95
1864,2,7000000,6466,7066,,600,170.53,2989003.2716499544,5237438.95
1865,2,47675400,6466,7057,,591,170.53,2989003.2716499544,5237438.95
1866,16,42000000,6466,6875,,409,170.53,2465023.1840707962,5237438.95
1867,7,510000,6471,7207,,736,170.53,3738553.685483871,5237438.95
1868,3,700000,6471,6497,,26,170.53,9246769.549865229,5237438.95
1869,24,1200000,6471,6542,,71,170.53,23456062.532786883,5237438.95
1870,22,600000,6476,6536,,60,170.53,2904103.2512077293,5237438.95
1871,19,800000,6476,6499,,23,170.53,6721340.5708154505,5237438.95
1872,10,650000,6477,6526,,49,170.53,8282326.220930233,5237438.95
1873,2,805580,6477,6494,,17,170.53,2989003.2716499544,5237438.95
1874,16,700000,6485,6494,,9,170.53,2465023.1840707962,5237438.95
1875,19,1102380,6486,6525,,39,170.53,6721340.5708154505,5237438.95
1876,11,600000,6486,6532,,46,170.53,1820371.57,5237438.95
1877,19,5000000,6490,6520,,30,170.53,6721340.5708154505,5237438.95
1878,21,750000,6491,6511,,20,170.53,17091199.984,5237438.95
1879,11,550000,6491,6532,,41,170.53,1820371.57,5237438.95
1880,6,700000,6491,6655,,164,170.53,1124713.2781954887,5237438.95
1881,11,2000000,6492,6585,,93,170.53,1820371.57,5237438.95
1882,15,850000,6492,6550,,58,170.53,4522577.48037889,5237438.95
1883,15,600000,6492,6547,,55,170.53,4522577.48037889,5237438.95
1884,2,850000,6499,6630,,131,170.53,2989003.2716499544,5237438.95
1885,2,900000,6500,6519,,19,170.53,2989003.2716499544,5237438.95
1886,3,80000000,6500,7831,,1331,170.53,9246769.549865229,5237438.95
1887,12,700000,6501,6536,,35,170.53,7658937.101338432,5237438.95
1888,3,3300000,6504,6578,,74,170.53,9246769.549865229,5237438.95
1889,15,600000,6505,6968,,463,170.53,4522577.48037889,5237438.95
1890,20,600000,6465,6507,,42,170.53,7597088.421768707,5237438.95
1891,17,575000,6508,6806,,298,170.53,1614143.0049603174,5237438.95
1892,5,600000,6508,6549,,41,170.53,1400922.5020242915,5237438.95
1893,5,1051200,6508,6567,,59,170.53,1400922.5020242915,5237438.95
1894,17,575000,6511,6806,,295,170.53,1614143.0049603174,5237438.95
1895,16,5500000,6512,7522,,1010,170.53,2465023.1840707962,5237438.95
1896,13,900000,6513,6541,,28,170.53,7795654.71978022,5237438.95
1897,10,68000000,6513,7383,,870,170.53,8282326.220930233,5237438.95
1898,18,1900000,6514,6976,,462,170.53,8584355.493548388,5237438.95
1899,9,915000,6514,6715,,201,170.53,3707403.8834951455,5237438.95
1900,1,6000000,6514,6567,,53,170.53,3325419.7044334975,5237438.95
1901,9,700000,6515,6745,,230,170.53,3707403.8834951455,5237438.95
1902,17,596415,6515,6542,,27,170.53,1614143.0049603174,5237438.95
1903,3,650000,6519,7058,,539,170.53,9246769.549865229,5237438.95
1904,7,1000000,6520,7003,,483,170.53,3738553.685483871,5237438.95
1905,2,800000,6525,6700,,175,170.53,2989003.2716499544,5237438.95
1906,1,650000,6525,6555,,30,170.53,3325419.7044334975,5237438.95
1907,17,550000,6526,6577,,51,170.53,1614143.0049603174,5237438.95
1908,1,1500000,6526,6582,,56,170.53,3325419.7044334975,5237438.95
1909,11,1200000,6528,6553,,25,170.53,1820371.57,5237438.95
1910,9,700000,6528,6578,,50,170.53,3707403.8834951455,5237438.95
1911,2,1100000,6528,6542,,14,170.53,2989003.2716499544,5237438.95
1912,15,1000000,6529,6543,,14,170.53,4522577.48037889,5237438.95
1913,3,64000000,6532,7642,,1110,170.53,9246769.549865229,5237438.95
1914,16,1100000,6532,6701,,169,170.53,2465023.1840707962,5237438.95
1915,15,550000,6533,6556,,23,170.53,4522577.48037889,5237438.95
1916,13,70000000,6533,7751,,1218,170.53,7795654.71978022,5237438.95
1917,10,71412460,6533,6907,,374,170.53,8282326.220930233,5237438.95
1918,0,660000,6533,6554,,21,170.53,8418173.322222222,5237438.95
1919,2,2000000,6534,8165,,1631,170.53,2989003.2716499544,5237438.95
1920,2,5500000,6535,8165,,1630,170.53,2989003.2716499544,5237438.95
1921,17,1000000,6535,6550,,15,170.53,1614143.0049603174,5237438.95
1922,2,5500000,6535,8165,,1630,170.53,2989003.2716499544,5237438.95
1923,22,612000,6535,7467,,932,170.53,2904103.2512077293,5237438.95
1924,15,550000,6535,6703,,168,170.53,4522577.48037889,5237438.95
1925,2,1054500,6536,6598,,62,170.53,2989003.2716499544,5237438.95
1926,17,800000,6536,6560,,24,170.53,1614143.0049603174,5237438.95
1927,11,1000000,6540,6729,,189,170.53,1820371.57,5237438.95
1928,11,1800000,6541,6577,,36,170.53,1820371.57,5237438.95
1929,11,2659600,6541,6609,,68,170.53,1820371.57,5237438.95
1930,2,800000,6541,6567,,26,170.53,2989003.2716499544,5237438.95
1931,0,1000000,6541,6575,,34,170.53,8418173.322222222,5237438.95
1932,18,1050000,6543,6617,,74,170.53,8584355.493548388,5237438.95
1933,15,600000,6548,6578,,30,170.53,4522577.48037889,5237438.95
1934,16,800000,6548,6585,,37,170.53,2465023.1840707962,5237438.95
1935,18,18000000,6548,7635,,1087,170.53,8584355.493548388,5237438.95
1936,1,638235,6548,6576,,28,170.53,3325419.7044334975,5237438.95
1937,19,800000,6548,6576,,28,170.53,6721340.5708154505,5237438.95
1938,18,62000000,6549,7676,,1127,170.53,8584355.493548388,5237438.95
1939,18,57000000,6549,7719,,1170,170.53,8584355.493548388,5237438.95
1940,11,750000,6550,6567,,17,170.53,1820371.57,5237438.95
1941,2,668820,6554,6604,,50,170.53,2989003.2716499544,5237438.95
1942,23,170000000,6555,7698,,1143,170.53,5772926.70157068,5237438.95
1943,23,170000000,6555,7591,,1036,170.53,5772926.70157068,5237438.95
1944,18,900000,6557,6577,,20,170.53,8584355.493548388,5237438.95
1945,24,999999,6561,6624,,63,170.53,23456062.532786883,5237438.95
1946,2,821100,6561,6604,,43,170.53,2989003.2716499544,5237438.95
1947,12,9000000,6562,6609,,47,170.53,7658937.101338432,5237438.95
1948,19,65266838,6563,8033,,1470,170.53,6721340.5708154505,5237438.95
1949,19,37742344,6563,8033,,1470,170.53,6721340.5708154505,5237438.95
1950,14,608000,6563,6584,,21,170.53,5826416.914893617,5237438.95
1951,11,607560,6564,6609,,45,170.53,1820371.57,5237438.95
1952,15,650000,6569,6647,,78,170.53,4522577.48037889,5237438.95
1953,15,650000,6569,6647,,78,170.53,4522577.48037889,5237438.95
1954,15,650000,6569,6647,,78,170.53,4522577.48037889,5237438.95
1955,15,600000,6570,6647,,77,170.53,4522577.48037889,5237438.95
1956,15,600000,6570,6647,,77,170.53,4522577.48037889,5237438.95
1957,15,600000,6570,6647,,77,170.53,4522577.48037889,5237438.95
1958,15,600000,6570,6647,,77,170.53,4522577.48037889,5237438.95
1959,2,828000,6571,6939,,368,170.53,2989003.2716499544,5237438.95
1960,15,700000,6574,6647,,73,170.53,4522577.48037889,5237438.95
1961,15,700000,6574,6647,,73,170.53,4522577.48037889,5237438.95
1962,15,700000,6574,6647,,73,170.53,4522577.48037889,5237438.95
1963,15,700000,6574,6647,,73,170.53,4522577.48037889,5237438.95
1964,15,700000,6574,6647,,73,170.53,4522577.48037889,5237438.95
1965,15,700000,6574,6647,,73,170.53,4522577.48037889,5237438.95
1966,15,600000,6574,6647,,73,170.53,4522577.48037889,5237438.95
1967,15,600000,6574,6647,,73,170.53,4522577.48037889,5237438.95
1968,15,700000,6574,6836,,262,170.53,4522577.48037889,5237438.95
1969,15,700000,6574,6836,,262,170.53,4522577.48037889,5237438.95
1970,15,700000,6574,6836,,262,170.53,4522577.48037889,5237438.95
1971,15,700000,6574,6836,,262,170.53,4522577.48037889,5237438.95
1972,15,600000,6574,6836,,262,170.53,4522577.48037889,5237438.95
1973,15,700000,6574,6836,,262,170.53,4522577.48037889,5237438.95
1974,15,700000,6574,6836,,262,170.53,4522577.48037889,5237438.95
1975,15,700000,6574,6836,,262,170.53,4522577.48037889,5237438.95
1976,15,700000,6574,6648,,74,170.53,4522577.48037889,5237438.95
1977,15,700000,6574,6648,,74,170.53,4522577.48037889,5237438.95
1978,15,600000,6574,6648,,74,170.53,4522577.48037889,5237438.95
1979,15,600000,6574,6648,,74,170.53,4522577.48037889,5237438.95
1980,2,950000,6575,6604,,29,170.53,2989003.2716499544,5237438.95
1981,15,600000,6577,6675,,98,170.53,4522577.48037889,5237438.95
1982,17,617420,6584,6780,,196,170.53,1614143.0049603174,5237438.95
1983,12,1500000,6585,6597,,12,170.53,7658937.101338432,5237438.95
1984,12,1000000,6585,6604,,19,170.53,7658937.101338432,5237438.95
1985,12,1000000,6595,7626,,1031,170.53,7658937.101338432,5237438.95
1986,12,1000000,6595,7626,,1031,170.53,7658937.101338432,5237438.95
1987,15,600000,6590,6647,,57,170.53,4522577.48037889,5237438.95
1988,15,600000,6590,6647,,57,170.53,4522577.48037889,5237438.95
1989,15,600000,6590,6647,,57,170.53,4522577.48037889,5237438.95
1990,15,600000,6590,6647,,57,170.53,4522577.48037889,5237438.95
1991,15,600000,6590,6647,,57,170.53,4522577.48037889,5237438.95
1992,15,600000,6590,6647,,57,170.53,4522577.48037889,5237438.95
1993,15,600000,6590,6647,,57,170.53,4522577.48037889,5237438.95
1994,15,600000,6590,6647,,57,170.53,4522577.48037889,5237438.95
1995,15,600000,6590,6647,,57,170.53,4522577.48037889,5237438.95
1996,15,600000,6590,6647,,57,170.53,4522577.48037889,5237438.95
1997,15,600000,6590,6647,,57,170.53,4522577.48037889,5237438.95
1998,4,40000000,6590,7179,,589,170.53,4297914.794871795,5237438.95
1999,15,600000,6590,6647,,57,170.53,4522577.48037889,5237438.95
2000,15,600000,6590,6647,,57,170.53,4522577.48037889,5237438.95
2001,15,600000,6590,6647,,57,170.53,4522577.48037889,5237438.95
2002,15,600000,6590,6647,,57,170.53,4522577.48037889,5237438.95
2003,15,600000,6590,6647,,57,170.53,4522577.48037889,5237438.95
2004,15,600000,6590,6647,,57,170.53,4522577.48037889,5237438.95
2005,15,600000,6590,6647,,57,170.53,4522577.48037889,5237438.95
2006,15,600000,6590,6647,,57,170.53,4522577.48037889,5237438.95
2007,15,600000,6590,6647,,57,170.53,4522577.48037889,5237438.95
2008,15,600000,6590,6647,,57,170.53,4522577.48037889,5237438.95
2009,15,600000,6590,6647,,57,170.53,4522577.48037889,5237438.95
2010,15,600000,6590,6647,,57,170.53,4522577.48037889,5237438.95
2011,15,600000,6590,6647,,57,170.53,4522577.48037889,5237438.95
2012,15,600000,6590,6647,,57,170.53,4522577.48037889,5237438.95
2013,15,600000,6591,6647,,56,170.53,4522577.48037889,5237438.95
2014,15,600000,6591,6647,,56,170.53,4522577.48037889,5237438.95
2015,15,600000,6591,6647,,56,170.53,4522577.48037889,5237438.95
2016,15,600000,6591,6647,,56,170.53,4522577.48037889,5237438.95
2017,15,600000,6591,6647,,56,170.53,4522577.48037889,5237438.95
2018,15,600000,6591,6647,,56,170.53,4522577.48037889,5237438.95
2019,15,600000,6591,6647,,56,170.53,4522577.48037889,5237438.95
2020,15,600000,6591,6647,,56,170.53,4522577.48037889,5237438.95
2021,15,600000,6591,6647,,56,170.53,4522577.48037889,5237438.95
2022,15,600000,6591,6647,,56,170.53,4522577.48037889,5237438.95
2023,15,600000,6591,6647,,56,170.53,4522577.48037889,5237438.95
2024,15,600000,6591,6647,,56,170.53,4522577.48037889,5237438.95
2025,15,600000,6591,6647,,56,170.53,4522577.48037889,5237438.95
2026,15,600000,6591,6647,,56,170.53,4522577.48037889,5237438.95
2027,15,600000,6591,6647,,56,170.53,4522577.48037889,5237438.95
2028,15,600000,6591,6647,,56,170.53,4522577.48037889,5237438.95
2029,15,600000,6591,6647,,56,170.53,4522577.48037889,5237438.95
2030,15,600000,6591,6647,,56,170.53,4522577.48037889,5237438.95
2031,15,600000,6591,6647,,56,170.53,4522577.48037889,5237438.95
2032,15,600000,6591,6647,,56,170.53,4522577.48037889,5237438.95
2033,15,600000,6591,6647,,56,170.53,4522577.48037889,5237438.95
2034,15,600000,6591,6647,,56,170.53,4522577.48037889,5237438.95
2035,15,600000,6591,6647,,56,170.53,4522577.48037889,5237438.95
2036,15,600000,6591,6647,,56,170.53,4522577.48037889,5237438.95
2037,15,600000,6591,6647,,56,170.53,4522577.48037889,5237438.95
2038,15,600000,6591,6647,,56,170.53,4522577.48037889,5237438.95
2039,15,600000,6591,6647,,56,170.53,4522577.48037889,5237438.95
2040,15,600000,6591,6647,,56,170.53,4522577.48037889,5237438.95
2041,15,600000,6591,6647,,56,170.53,4522577.48037889,5237438.95
2042,15,600000,6591,6647,,56,170.53,4522577.48037889,5237438.95
2043,15,600000,6591,6647,,56,170.53,4522577.48037889,5237438.95
2044,15,600000,6591,6647,,56,170.53,4522577.48037889,5237438.95
2045,15,600000,6591,6647,,56,170.53,4522577.48037889,5237438.95
2046,15,600000,6591,6647,,56,170.53,4522577.48037889,5237438.95
2047,15,600000,6591,6647,,56,170.53,4522577.48037889,5237438.95
2048,15,600000,6591,6647,,56,170.53,4522577.48037889,5237438.95
2049,15,600000,6591,6647,,56,170.53,4522577.48037889,5237438.95
2050,15,600000,6591,6647,,56,170.53,4522577.48037889,5237438.95
2051,17,750000,6591,6616,,25,170.53,1614143.0049603174,5237438.95
2052,3,30000000,6592,7193,,601,170.53,9246769.549865229,5237438.95
2053,2,2500000,6596,6648,,52,170.53,2989003.2716499544,5237438.95
2054,5,750000,6598,6632,,34,170.53,1400922.5020242915,5237438.95
2055,2,650000,6598,7536,,938,170.53,2989003.2716499544,5237438.95
2056,1,16000000,6602,7597,,995,170.53,3325419.7044334975,5237438.95
2057,1,24000000,6602,7613,,1011,170.53,3325419.7044334975,5237438.95
2058,11,720000,6605,6645,,40,170.53,1820371.57,5237438.95
2059,12,50000000,6605,7284,,679,170.53,7658937.101338432,5237438.95
2060,12,9000000,6606,6655,,49,170.53,7658937.101338432,5237438.95
2061,6,600000,6609,6774,,165,170.53,1124713.2781954887,5237438.95
2062,15,680000,6616,6652,,36,170.53,4522577.48037889,5237438.95
2063,3,4000000,6616,6872,,256,170.53,9246769.549865229,5237438.95
2064,3,550000,6616,6644,,28,170.53,9246769.549865229,5237438.95
2065,3,600000,6617,6651,,34,170.53,9246769.549865229,5237438.95
2066,15,1200000,6617,6731,,114,170.53,4522577.48037889,5237438.95
2067,17,1000000,6619,6675,,56,170.53,1614143.0049603174,5237438.95
2068,12,69000000,6620,7697,,1077,170.53,7658937.101338432,5237438.95
2069,2,810000,6620,6786,,166,170.53,2989003.2716499544,5237438.95
2070,20,550000,6625,6696,,71,170.53,7597088.421768707,5237438.95
2071,3,7595000,6626,8103,,1477,170.53,9246769.549865229,5237438.95
2072,15,630000,6627,6690,,63,170.53,4522577.48037889,5237438.95
2073,15,750000,6630,6674,,44,170.53,4522577.48037889,5237438.95
2074,15,800000,6631,6686,,55,170.53,4522577.48037889,5237438.95
2075,18,700000,6631,6739,,108,170.53,8584355.493548388,5237438.95
2076,15,710750,6631,6646,,15,170.53,4522577.48037889,5237438.95
2077,19,850000,6632,6648,,16,170.53,6721340.5708154505,5237438.95
2078,19,32500000,6633,8797,,2164,170.53,6721340.5708154505,5237438.95
2079,10,36000000,6634,6963,,329,170.53,8282326.220930233,5237438.95
2080,10,6110400,6634,6963,,329,170.53,8282326.220930233,5237438.95
2081,16,1200000,6638,6787,,149,170.53,2465023.1840707962,5237438.95
2082,5,750000,6638,6647,,9,170.53,1400922.5020242915,5237438.95
2083,24,70000000,6639,7429,,790,170.53,23456062.532786883,5237438.95
2084,11,1200000,6640,6655,,15,170.53,1820371.57,5237438.95
2085,15,750000,6640,6697,,57,170.53,4522577.48037889,5237438.95
2086,24,150000000,6644,7946,,1302,170.53,23456062.532786883,5237438.95
2087,24,100000000,6645,7997,,1352,170.53,23456062.532786883,5237438.95
2088,16,710000,6651,6672,,21,170.53,2465023.1840707962,5237438.95
2089,17,550000,6653,6984,,331,170.53,1614143.0049603174,5237438.95
2090,21,6000000,6653,7638,,985,170.53,17091199.984,5237438.95
2091,12,100000000,6653,7180,,527,170.53,7658937.101338432,5237438.95
2092,11,1500000,6654,6675,,21,170.53,1820371.57,5237438.95
2093,24,80000000,6655,7862,,1207,170.53,23456062.532786883,5237438.95
2094,2,700000,6660,6693,,33,170.53,2989003.2716499544,5237438.95
2095,2,900000,6668,6808,,140,159.56,2989003.2716499544,6271224.19
2096,23,20000000,6672,7451,,779,159.56,5772926.70157068,6271224.19
2097,22,800000,6673,6703,,30,159.56,2904103.2512077293,6271224.19
2098,17,600000,6674,6723,,49,159.56,1614143.0049603174,6271224.19
2099,2,630000,6679,6842,,163,159.56,2989003.2716499544,6271224.19
2100,16,640000,6680,6694,,14,159.56,2465023.1840707962,6271224.19
2101,1,847015,6682,6703,,21,159.56,3325419.7044334975,6271224.19
2102,17,1035600,6683,7107,,424,159.56,1614143.0049603174,6271224.19
2103,15,650000,6686,7148,,462,159.56,4522577.48037889,6271224.19
2104,11,700000,6686,6744,,58,159.56,1820371.57,6271224.19
2105,12,575000,6686,6786,,100,159.56,7658937.101338432,6271224.19
2106,2,995000,6687,6721,,34,159.56,2989003.2716499544,6271224.19
2107,2,700000,6687,6728,,41,159.56,2989003.2716499544,6271224.19
2108,5,650000,6689,6732,,43,159.56,1400922.5020242915,6271224.19
2109,16,1070000,6697,6759,,62,159.56,2465023.1840707962,6271224.19
2110,21,2400000,6697,6710,,13,159.56,17091199.984,6271224.19
2111,17,561975,6701,6773,,72,159.56,1614143.0049603174,6271224.19
2112,17,860605,6701,6729,,28,159.56,1614143.0049603174,6271224.19
2113,16,1135000,6701,6914,,213,159.56,2465023.1840707962,6271224.19
2114,17,1000000,6702,6732,,30,159.56,1614143.0049603174,6271224.19
2115,20,1200000,6702,6722,,20,159.56,7597088.421768707,6271224.19
2116,17,567000,6702,6721,,19,159.56,1614143.0049603174,6271224.19
2117,24,90000000,6704,8332,,1628,159.56,23456062.532786883,6271224.19
2118,23,650000,6707,6738,,31,159.56,5772926.70157068,6271224.19
2119,17,600000,6708,6724,,16,159.56,1614143.0049603174,6271224.19
2120,16,6000000,6710,7521,,811,159.56,2465023.1840707962,6271224.19
2121,16,35118000,6710,7522,,812,159.56,2465023.1840707962,6271224.19
2122,16,64000000,6710,7522,,812,159.56,2465023.1840707962,6271224.19
2123,3,750000,6710,6742,,32,159.56,9246769.549865229,6271224.19
2124,12,1000000,6711,6749,,38,159.56,7658937.101338432,6271224.19
2125,1,700000,6717,6744,,27,159.56,3325419.7044334975,6271224.19
2126,16,647000,6717,6773,,56,159.56,2465023.1840707962,6271224.19
2127,9,871400,6718,6766,,48,159.56,3707403.8834951455,6271224.19
2128,11,6000000,6718,7270,,552,159.56,1820371.57,6271224.19
2129,5,600000,6721,6784,,63,159.56,1400922.5020242915,6271224.19
2130,19,700000,6722,6765,,43,159.56,6721340.5708154505,6271224.19
2131,6,900000,6722,6763,,41,159.56,1124713.2781954887,6271224.19
2132,21,1200000,6723,6778,,55,159.56,17091199.984,6271224.19
2133,16,750000,6723,6736,,13,159.56,2465023.1840707962,6271224.19
2134,16,940000,6723,6771,,48,159.56,2465023.1840707962,6271224.19
2135,16,35000000,6725,7789,,1064,159.56,2465023.1840707962,6271224.19
2136,17,700000,6725,6750,,25,159.56,1614143.0049603174,6271224.19
2137,3,30000000,6728,7764,,1036,159.56,9246769.549865229,6271224.19
2138,10,1000000,6729,6820,,91,159.56,8282326.220930233,6271224.19
2139,2,600000,6729,6745,,16,159.56,2989003.2716499544,6271224.19
2140,0,510600,6730,6903,,173,159.56,8418173.322222222,6271224.19
2141,17,1000000,6731,6767,,36,159.56,1614143.0049603174,6271224.19
2142,16,936000,6738,6779,,41,159.56,2465023.1840707962,6271224.19
2143,14,660000,6742,6791,,49,159.56,5826416.914893617,6271224.19
2144,2,800000,6743,6820,,77,159.56,2989003.2716499544,6271224.19
2145,11,1000000,6743,6885,,142,159.56,1820371.57,6271224.19
2146,17,1100000,6744,6780,,36,159.56,1614143.0049603174,6271224.19
2147,2,900000,6744,6889,,145,159.56,2989003.2716499544,6271224.19
2148,14,1000000,6749,6767,,18,159.56,5826416.914893617,6271224.19
2149,17,1150000,6749,6770,,21,159.56,1614143.0049603174,6271224.19
2150,5,600000,6750,6791,,41,159.56,1400922.5020242915,6271224.19
2151,15,700000,6751,6795,,44,159.56,4522577.48037889,6271224.19
2152,16,676500,6751,6777,,26,159.56,2465023.1840707962,6271224.19
2153,0,665000,6752,6784,,32,159.56,8418173.322222222,6271224.19
2154,23,600000,6757,6801,,44,159.56,5772926.70157068,6271224.19
2155,11,750000,6758,6990,,232,159.56,1820371.57,6271224.19
2156,3,110000000,6758,7796,,1038,159.56,9246769.549865229,6271224.19
2157,2,835350,6758,6795,,37,159.56,2989003.2716499544,6271224.19
2158,15,950000,6759,6975,,216,159.56,4522577.48037889,6271224.19
2159,24,124000000,6763,7688,,925,159.56,23456062.532786883,6271224.19
2160,19,600000,6763,6806,,43,159.56,6721340.5708154505,6271224.19
2161,1,750000,6764,6779,,15,159.56,3325419.7044334975,6271224.19
2162,12,1000000,6765,7066,,301,159.56,7658937.101338432,6271224.19
2163,17,700000,6765,6792,,27,159.56,1614143.0049603174,6271224.19
2164,16,550000,6772,6788,,16,159.56,2465023.1840707962,6271224.19
2165,12,5000000,6772,7319,,547,159.56,7658937.101338432,6271224.19
2166,16,1850000,6772,6800,,28,159.56,2465023.1840707962,6271224.19
2167,17,600000,6772,6828,,56,159.56,1614143.0049603174,6271224.19
2168,4,750000,6773,6858,,85,159.56,4297914.794871795,6271224.19
2169,15,700000,6774,6801,,27,159.56,4522577.48037889,6271224.19
2170,16,1000000,6779,6837,,58,159.56,2465023.1840707962,6271224.19
2171,4,600000,6780,6869,,89,159.56,4297914.794871795,6271224.19
2172,24,150000000,6781,7654,,873,159.56,23456062.532786883,6271224.19
2173,5,650000,6781,6885,,104,159.56,1400922.5020242915,6271224.19
2174,3,1000000,6781,6820,,39,159.56,9246769.549865229,6271224.19
2175,16,1500000,6784,6829,,45,159.56,2465023.1840707962,6271224.19
2176,5,1000000,6784,6799,,15,159.56,1400922.5020242915,6271224.19
2177,15,650000,6785,6808,,23,159.56,4522577.48037889,6271224.19
2178,12,1150000,6787,6849,,62,159.56,7658937.101338432,6271224.19
2179,22,775000,6787,6827,,40,159.56,2904103.2512077293,6271224.19
2180,6,600000,6788,6842,,54,159.56,1124713.2781954887,6271224.19
2181,2,33000000,6788,7684,,896,159.56,2989003.2716499544,6271224.19
2182,6,600000,6788,6856,,68,159.56,1124713.2781954887,6271224.19
2183,2,700000,6788,6919,,131,159.56,2989003.2716499544,6271224.19
2184,2,800000,6791,7102,,311,159.56,2989003.2716499544,6271224.19
2185,3,39000000,6792,7850,,1058,159.56,9246769.549865229,6271224.19
2186,13,540000,6792,6973,,181,159.56,7795654.71978022,6271224.19
2187,3,10000000,6795,6827,,32,159.56,9246769.549865229,6271224.19
2188,6,1000000,6800,6857,,57,159.56,1124713.2781954887,6271224.19
2189,12,650000,6800,6828,,28,159.56,7658937.101338432,6271224.19
2190,17,925000,6801,7292,,491,159.56,1614143.0049603174,6271224.19
2191,15,1000000,6807,6886,,79,159.56,4522577.48037889,6271224.19
2192,22,750000,6807,6836,,29,159.56,2904103.2512077293,6271224.19
2193,16,800000,6808,6842,,34,159.56,2465023.1840707962,6271224.19
2194,6,750000,6809,6829,,20,159.56,1124713.2781954887,6271224.19
2195,17,25000000,6812,7782,,970,159.56,1614143.0049603174,6271224.19
2196,11,1000000,6812,6906,,94,159.56,1820371.57,6271224.19
2197,17,790200,6814,6903,,89,159.56,1614143.0049603174,6271224.19
2198,22,600000,6814,6850,,36,159.56,2904103.2512077293,6271224.19
2199,2,700000,6815,7373,,558,159.56,2989003.2716499544,6271224.19
2200,2,800000,6820,6850,,30,159.56,2989003.2716499544,6271224.19
2201,19,7390000,6822,8765,,1943,159.56,6721340.5708154505,6271224.19
2202,19,8025000,6822,8766,,1944,159.56,6721340.5708154505,6271224.19
2203,19,6515000,6822,8780,,1958,159.56,6721340.5708154505,6271224.19
2204,19,7865000,6822,8781,,1959,159.56,6721340.5708154505,6271224.19
2205,12,900000,6827,6844,,17,159.56,7658937.101338432,6271224.19
2206,13,600000,6828,6850,,22,159.56,7795654.71978022,6271224.19
2207,16,750000,6829,6836,,7,159.56,2465023.1840707962,6271224.19
2208,11,550000,6830,6862,,32,159.56,1820371.57,6271224.19
2209,22,600000,6830,6850,,20,159.56,2904103.2512077293,6271224.19
2210,12,93000000,6840,7865,,1025,159.56,7658937.101338432,6271224.19
2211,13,600000,6841,6878,,37,159.56,7795654.71978022,6271224.19
2212,0,800000,6841,6861,,20,159.56,8418173.322222222,6271224.19
2213,24,830000,6848,6879,,31,159.56,23456062.532786883,6271224.19
2214,16,750000,6850,6865,,15,159.56,2465023.1840707962,6271224.19
2215,12,1000000,6850,6886,,36,159.56,7658937.101338432,6271224.19
2216,11,8000000,6851,6893,,42,159.56,1820371.57,6271224.19
2217,17,1000000,6854,6892,,38,159.56,1614143.0049603174,6271224.19
2218,8,751000,6854,6883,,29,159.56,1501617.2191780822,6271224.19
2219,16,600000,6855,6900,,45,159.56,2465023.1840707962,6271224.19
2220,19,600000,6856,6886,,30,159.56,6721340.5708154505,6271224.19
2221,19,1300000,6856,6870,,14,159.56,6721340.5708154505,6271224.19
2222,3,1500000,6858,6890,,32,159.56,9246769.549865229,6271224.19
2223,19,700000,6861,6878,,17,159.56,6721340.5708154505,6271224.19
2224,15,550000,6861,6975,,114,159.56,4522577.48037889,6271224.19
2225,24,2000000,6862,6933,,71,159.56,23456062.532786883,6271224.19
2226,22,750000,6862,6961,,99,159.56,2904103.2512077293,6271224.19
2227,16,1550000,6864,6878,,14,159.56,2465023.1840707962,6271224.19
2228,23,800000,6864,6905,,41,159.56,5772926.70157068,6271224.19
2229,23,550000,6865,6879,,14,159.56,5772926.70157068,6271224.19
2230,15,750000,6869,6905,,36,159.56,4522577.48037889,6271224.19
2231,12,650000,6869,6893,,24,159.56,7658937.101338432,6271224.19
2232,15,550000,6870,6935,,65,159.56,4522577.48037889,6271224.19
2233,2,1000000,6871,6970,,99,159.56,2989003.2716499544,6271224.19
2234,11,20000000,6872,7253,,381,159.56,1820371.57,6271224.19
2235,17,750000,6872,6941,,69,159.56,1614143.0049603174,6271224.19
2236,11,1000000,6875,6892,,17,159.56,1820371.57,6271224.19
2237,22,600000,6875,6886,,11,159.56,2904103.2512077293,6271224.19
2238,18,900000,6875,6920,,45,159.56,8584355.493548388,6271224.19
2239,13,175000000,6875,7775,,900,159.56,7795654.71978022,6271224.19
2240,19,1000000,6877,6898,,21,159.56,6721340.5708154505,6271224.19
2241,24,123000000,6878,7849,,971,159.56,23456062.532786883,6271224.19
2242,24,111222300,6878,7898,,1020,159.56,23456062.532786883,6271224.19
2243,24,82104000,6878,7925,,1047,159.56,23456062.532786883,6271224.19
2244,15,195000000,6878,8681,,1803,159.56,4522577.48037889,6271224.19
2245,15,9200000,6878,8887,,2009,159.56,4522577.48037889,6271224.19
2246,17,1000000,6878,6913,,35,159.56,1614143.0049603174,6271224.19
2247,15,700000,6879,6897,,18,159.56,4522577.48037889,6271224.19
2248,24,750000,6879,6890,,11,159.56,23456062.532786883,6271224.19
2249,2,10500000,6879,7380,,501,159.56,2989003.2716499544,6271224.19
2250,2,650000,6883,7194,,311,159.56,2989003.2716499544,6271224.19
2251,11,2400000,6884,7137,,253,159.56,1820371.57,6271224.19
2252,15,4620000,6885,7333,,448,159.56,4522577.48037889,6271224.19
2253,15,600000,6885,7333,,448,159.56,4522577.48037889,6271224.19
2254,15,600000,6885,7333,,448,159.56,4522577.48037889,6271224.19
2255,16,600000,6886,6994,,108,159.56,2465023.1840707962,6271224.19
2256,15,930000,6886,6926,,40,159.56,4522577.48037889,6271224.19
2257,22,600000,6886,7162,,276,159.56,2904103.2512077293,6271224.19
2258,10,900000,6890,7144,,254,159.56,8282326.220930233,6271224.19
2259,17,635000,6891,6919,,28,159.56,1614143.0049603174,6271224.19
2260,18,620500,6891,6974,,83,159.56,8584355.493548388,6271224.19
2261,16,800000,6891,6905,,14,159.56,2465023.1840707962,6271224.19
2262,22,570000,6892,6919,,27,159.56,2904103.2512077293,6271224.19
2263,17,1000000,6896,6912,,16,159.56,1614143.0049603174,6271224.19
2264,0,80000000,6897,8046,,1149,159.56,8418173.322222222,6271224.19
2265,19,675000,6897,6942,,45,159.56,6721340.5708154505,6271224.19
2266,17,600000,6897,6921,,24,159.56,1614143.0049603174,6271224.19
2267,5,1000000,6897,6917,,20,159.56,1400922.5020242915,6271224.19
2268,11,750000,6898,6926,,28,159.56,1820371.57,6271224.19
2269,15,584000,6898,6938,,40,159.56,4522577.48037889,6271224.19
2270,12,60000000,6898,7430,,532,159.56,7658937.101338432,6271224.19
2271,2,600000,6898,6933,,35,159.56,2989003.2716499544,6271224.19
2272,2,600000,6898,6933,,35,159.56,2989003.2716499544,6271224.19
2273,18,800000,6899,6956,,57,159.56,8584355.493548388,6271224.19
2274,16,8000000,6903,6926,,23,159.56,2465023.1840707962,6271224.19
2275,3,29670000,6903,7950,,1047,159.56,9246769.549865229,6271224.19
2276,17,600000,6913,6948,,35,159.56,1614143.0049603174,6271224.19
2277,14,700000,6913,7201,,288,159.56,5826416.914893617,6271224.19
2278,7,64000000,6918,7165,,247,159.56,3738553.685483871,6271224.19
2279,11,65000000,6918,8062,,1144,159.56,1820371.57,6271224.19
2280,22,10000000,6920,7513,,593,159.56,2904103.2512077293,6271224.19
2281,16,1000000,6920,6947,,27,159.56,2465023.1840707962,6271224.19
2282,22,10000000,6920,7513,,593,159.56,2904103.2512077293,6271224.19
2283,22,5000000,6920,7491,,571,159.56,2904103.2512077293,6271224.19
2284,22,5000000,6920,7491,,571,159.56,2904103.2512077293,6271224.19
2285,22,5000000,6920,7491,,571,159.56,2904103.2512077293,6271224.19
2286,22,5000000,6920,7491,,571,159.56,2904103.2512077293,6271224.19
2287,22,5000000,6920,7491,,571,159.56,2904103.2512077293,6271224.19
2288,22,5000000,6920,7491,,571,159.56,2904103.2512077293,6271224.19
2289,22,5000000,6920,7491,,571,159.56,2904103.2512077293,6271224.19
2290,22,5000000,6920,7491,,571,159.56,2904103.2512077293,6271224.19
2291,22,5000000,6920,7491,,571,159.56,2904103.2512077293,6271224.19
2292,22,5000000,6920,7491,,571,159.56,2904103.2512077293,6271224.19
2293,22,5000000,6920,7491,,571,159.56,2904103.2512077293,6271224.19
2294,22,5000000,6920,7491,,571,159.56,2904103.2512077293,6271224.19
2295,22,5000000,6920,7491,,571,159.56,2904103.2512077293,6271224.19
2296,22,5000000,6920,7491,,571,159.56,2904103.2512077293,6271224.19
2297,22,5000000,6920,7491,,571,159.56,2904103.2512077293,6271224.19
2298,22,5000000,6920,7491,,571,159.56,2904103.2512077293,6271224.19
2299,22,5000000,6920,7491,,571,159.56,2904103.2512077293,6271224.19
2300,22,5000000,6920,7491,,571,159.56,2904103.2512077293,6271224.19
2301,22,5000000,6920,7491,,571,159.56,2904103.2512077293,6271224.19
2302,22,5000000,6920,7491,,571,159.56,2904103.2512077293,6271224.19
2303,22,5000000,6920,7491,,571,159.56,2904103.2512077293,6271224.19
2304,22,5000000,6920,7491,,571,159.56,2904103.2512077293,6271224.19
2305,22,5000000,6920,7491,,571,159.56,2904103.2512077293,6271224.19
2306,22,5000000,6920,7491,,571,159.56,2904103.2512077293,6271224.19
2307,12,1400000,6921,7085,,164,159.56,7658937.101338432,6271224.19
2308,2,700000,6921,6935,,14,159.56,2989003.2716499544,6271224.19
2309,22,800000,6925,7261,,336,159.56,2904103.2512077293,6271224.19
2310,2,870000,6925,6967,,42,159.56,2989003.2716499544,6271224.19
2311,1,590000,6926,6952,,26,159.56,3325419.7044334975,6271224.19
2312,16,5000000,6926,7270,,344,159.56,2465023.1840707962,6271224.19
2313,16,700000,6926,6942,,16,159.56,2465023.1840707962,6271224.19
2314,18,160000000,6927,8297,,1370,159.56,8584355.493548388,6271224.19
2315,18,160000000,6927,8326,,1399,159.56,8584355.493548388,6271224.19
2316,24,70000000,6927,7978,,1051,159.56,23456062.532786883,6271224.19
2317,17,565000,6927,6963,,36,159.56,1614143.0049603174,6271224.19
2318,2,650000,6928,6967,,39,159.56,2989003.2716499544,6271224.19
2319,23,600000,6932,6941,,9,159.56,5772926.70157068,6271224.19
2320,11,1000000,6941,6997,,56,159.56,1820371.57,6271224.19
2321,2,1100000,6941,7247,,306,159.56,2989003.2716499544,6271224.19
2322,24,505000000,6941,8447,,1506,159.56,23456062.532786883,6271224.19
2323,15,560000,6942,6973,,31,159.56,4522577.48037889,6271224.19
2324,21,8000000,6942,6961,,19,159.56,17091199.984,6271224.19
2325,8,550000,6942,6963,,21,159.56,1501617.2191780822,6271224.19
2326,21,2000000,6946,6976,,30,159.56,17091199.984,6271224.19
2327,17,1000000,6947,6960,,13,159.56,1614143.0049603174,6271224.19
2328,11,2000000,6949,6990,,41,159.56,1820371.57,6271224.19
2329,2,950000,6949,7200,,251,159.56,2989003.2716499544,6271224.19
2330,6,600000,6954,6981,,27,159.56,1124713.2781954887,6271224.19
2331,12,2000000,6954,7002,,48,159.56,7658937.101338432,6271224.19
2332,12,600000,6955,6990,,35,159.56,7658937.101338432,6271224.19
2333,11,700000,6956,6980,,24,159.56,1820371.57,6271224.19
2334,15,40000000,6960,7788,,828,159.56,4522577.48037889,6271224.19
2335,2,800000,6962,7229,,267,159.56,2989003.2716499544,6271224.19
2336,16,800000,6967,7106,,139,159.56,2465023.1840707962,6271224.19
2337,15,1081000,6968,7018,,50,159.56,4522577.48037889,6271224.19
2338,19,800000,6969,7065,,96,159.56,6721340.5708154505,6271224.19
2339,5,600000,6969,6994,,25,159.56,1400922.5020242915,6271224.19
2340,12,850000,6970,6998,,28,159.56,7658937.101338432,6271224.19
2341,18,599410,6974,7114,,140,159.56,8584355.493548388,6271224.19
2342,12,1000000,6981,7897,,916,159.56,7658937.101338432,6271224.19
2343,2,1000000,6982,6998,,16,159.56,2989003.2716499544,6271224.19
2344,12,750000,6982,7015,,33,159.56,7658937.101338432,6271224.19
2345,23,9000000,6983,7969,,986,159.56,5772926.70157068,6271224.19
2346,5,600000,6987,7073,,86,159.56,1400922.5020242915,6271224.19
2347,14,50000000,6988,8566,,1578,159.56,5826416.914893617,6271224.19
2348,19,1000000,6995,7096,,101,159.56,6721340.5708154505,6271224.19
2349,17,700000,7001,7058,,57,159.56,1614143.0049603174,6271224.19
2350,17,1000000,7002,7057,,55,159.56,1614143.0049603174,6271224.19
2351,2,900000,7002,7082,,80,159.56,2989003.2716499544,6271224.19
2352,13,3000000,7003,7087,,84,159.56,7795654.71978022,6271224.19
2353,19,5000000,7003,7283,,280,159.56,6721340.5708154505,6271224.19
2354,19,920314,7011,7324,,313,159.56,6721340.5708154505,6271224.19
2355,18,611390,7012,7114,,102,159.56,8584355.493548388,6271224.19
2356,18,609350,7012,7120,,108,159.56,8584355.493548388,6271224.19
2357,12,65000000,7015,7568,,553,159.56,7658937.101338432,6271224.19
2358,17,650000,7016,7352,,336,159.56,1614143.0049603174,6271224.19
2359,15,1011750,7017,7059,,42,159.56,4522577.48037889,6271224.19
2360,3,101000000,7017,8426,,1409,159.56,9246769.549865229,6271224.19
2361,22,715000,7017,7033,,16,159.56,2904103.2512077293,6271224.19
2362,24,82000000,7018,8242,,1224,159.56,23456062.532786883,6271224.19
2363,12,60000000,7018,8080,,1062,159.56,7658937.101338432,6271224.19
2364,11,800000,7018,7270,,252,159.56,1820371.57,6271224.19
2365,6,800000,7019,7096,,77,159.56,1124713.2781954887,6271224.19
2366,15,63000000,7019,7823,,804,159.56,4522577.48037889,6271224.19
2367,4,650000,7020,7177,,157,159.56,4297914.794871795,6271224.19
2368,22,800000,7021,7079,,58,159.56,2904103.2512077293,6271224.19
2369,11,3000000,7021,7193,,172,159.56,1820371.57,6271224.19
2370,15,60000000,7022,7873,,851,159.56,4522577.48037889,6271224.19
2371,16,44000000,7025,8012,,987,159.56,2465023.1840707962,6271224.19
2372,16,44000000,7025,7968,,943,159.56,2465023.1840707962,6271224.19
2373,16,80000000,7025,8417,,1392,159.56,2465023.1840707962,6271224.19
2374,1,700000,7026,7430,,404,159.56,3325419.7044334975,6271224.19
2375,1,700000,7026,7698,,672,159.56,3325419.7044334975,6271224.19
2376,2,122000000,7029,7985,,956,159.56,2989003.2716499544,6271224.19
2377,2,700000,7029,7060,,31,159.56,2989003.2716499544,6271224.19
2378,2,1340000,7029,7352,,323,159.56,2989003.2716499544,6271224.19
2379,2,650000,7029,7352,,323,159.56,2989003.2716499544,6271224.19
2380,2,50000000,7029,7984,,955,159.56,2989003.2716499544,6271224.19
2381,3,30000000,6849,8004,,1155,159.56,9246769.549865229,6271224.19
2382,9,580000,7031,7505,,474,155.74,3707403.8834951455,6918446.56
2383,9,580000,7031,7527,,496,155.74,3707403.8834951455,6918446.56
2384,18,536330,7032,7163,,131,155.74,8584355.493548388,6918446.56
2385,18,552680,7032,7136,,104,155.74,8584355.493548388,6918446.56
2386,24,41122000,7040,7939,,899,155.74,23456062.532786883,6918446.56
2387,17,1000000,7046,7087,,41,155.74,1614143.0049603174,6918446.56
2388,1,900000,7046,7073,,27,155.74,3325419.7044334975,6918446.56
2389,17,3000000,7047,7381,,334,155.74,1614143.0049603174,6918446.56
2390,17,650000,7052,7108,,56,155.74,1614143.0049603174,6918446.56
2391,16,633500,7053,7095,,42,155.74,2465023.1840707962,6918446.56
2392,19,800000,7053,7068,,15,155.74,6721340.5708154505,6918446.56
2393,16,600000,7053,7109,,56,155.74,2465023.1840707962,6918446.56
2394,11,1000000,7053,7072,,19,155.74,1820371.57,6918446.56
2395,24,260000000,7054,8618,,1564,155.74,23456062.532786883,6918446.56
2396,3,8000000,7057,7191,,134,155.74,9246769.549865229,6918446.56
2397,11,1000000,7065,7099,,34,155.74,1820371.57,6918446.56
2398,18,1000000,7066,7107,,41,155.74,8584355.493548388,6918446.56
2399,11,600000,7066,7190,,124,155.74,1820371.57,6918446.56
2400,18,587520,7071,7163,,92,155.74,8584355.493548388,6918446.56
2401,12,2000000,7081,7166,,85,155.74,7658937.101338432,6918446.56
2402,12,2000000,7081,7165,,84,155.74,7658937.101338432,6918446.56
2403,16,650000,7081,7134,,53,155.74,2465023.1840707962,6918446.56
2404,13,579000,7085,7235,,150,155.74,7795654.71978022,6918446.56
2405,15,1245000,7085,7134,,49,155.74,4522577.48037889,6918446.56
2406,13,519000,7086,7225,,139,155.74,7795654.71978022,6918446.56
2407,16,800000,7086,7176,,90,155.74,2465023.1840707962,6918446.56
2408,2,900000,7087,7346,,259,155.74,2989003.2716499544,6918446.56
2409,10,600000,7087,7117,,30,155.74,8282326.220930233,6918446.56
2410,17,1000000,7088,7123,,35,155.74,1614143.0049603174,6918446.56
2411,16,1600000,7093,7114,,21,155.74,2465023.1840707962,6918446.56
2412,4,19000000,7096,7554,,458,155.74,4297914.794871795,6918446.56
2413,17,800000,7096,7121,,25,155.74,1614143.0049603174,6918446.56
2414,12,2000000,7096,7156,,60,155.74,7658937.101338432,6918446.56
2415,17,900000,7099,7113,,14,155.74,1614143.0049603174,6918446.56
2416,2,750000,7102,7234,,132,155.74,2989003.2716499544,6918446.56
2417,16,1050000,7109,7122,,13,155.74,2465023.1840707962,6918446.56
2418,11,1000000,7109,7136,,27,155.74,1820371.57,6918446.56
2419,11,2000000,7110,7124,,14,155.74,1820371.57,6918446.56
2420,0,600000,7121,7143,,22,155.74,8418173.322222222,6918446.56
2421,2,975000,7123,7369,,246,155.74,2989003.2716499544,6918446.56
2422,3,750000,7123,7194,,71,155.74,9246769.549865229,6918446.56
2423,2,600000,7128,7333,,205,155.74,2989003.2716499544,6918446.56
2424,3,900000,7130,7176,,46,155.74,9246769.549865229,6918446.56
2425,4,600000,7130,7206,,76,155.74,4297914.794871795,6918446.56
2426,15,700000,7131,7185,,54,155.74,4522577.48037889,6918446.56
2427,7,925000,7131,7159,,28,155.74,3738553.685483871,6918446.56
2428,22,1050000,7132,7253,,121,155.74,2904103.2512077293,6918446.56
2429,1,1264200,7134,7158,,24,155.74,3325419.7044334975,6918446.56
2430,18,800000,7134,7215,,81,155.74,8584355.493548388,6918446.56
2431,15,3000000,7134,7523,,389,155.74,4522577.48037889,6918446.56
2432,4,600000,7135,7184,,49,155.74,4297914.794871795,6918446.56
2433,15,800000,7136,7176,,40,155.74,4522577.48037889,6918446.56
2434,17,700000,7136,7198,,62,155.74,1614143.0049603174,6918446.56
2435,16,800000,7137,7170,,33,155.74,2465023.1840707962,6918446.56
2436,21,50000000,7137,8459,,1322,155.74,17091199.984,6918446.56
2437,5,600000,7142,7222,,80,155.74,1400922.5020242915,6918446.56
2438,19,600000,7144,7193,,49,155.74,6721340.5708154505,6918446.56
2439,18,1800000,7148,7200,,52,155.74,8584355.493548388,6918446.56
2440,17,878460,7148,7165,,17,155.74,1614143.0049603174,6918446.56
2441,17,600000,7149,7352,,203,155.74,1614143.0049603174,6918446.56
2442,17,800000,7150,7228,,78,155.74,1614143.0049603174,6918446.56
2443,16,750000,7150,7205,,55,155.74,2465023.1840707962,6918446.56
2444,16,1000000,7151,7193,,42,155.74,2465023.1840707962,6918446.56
2445,11,2500000,7151,7177,,26,155.74,1820371.57,6918446.56
2446,11,2000000,7152,7297,,145,155.74,1820371.57,6918446.56
2447,0,750000,7155,7200,,45,155.74,8418173.322222222,6918446.56
2448,8,900000,7156,7178,,22,155.74,1501617.2191780822,6918446.56
2449,2,87500000,7157,7656,,499,155.74,2989003.2716499544,6918446.56
2450,15,800000,7158,7208,,50,155.74,4522577.48037889,6918446.56
2451,12,750000,7158,7184,,26,155.74,7658937.101338432,6918446.56
2452,2,2900000,7158,7508,,350,155.74,2989003.2716499544,6918446.56
2453,13,1000000,7159,7170,,11,155.74,7795654.71978022,6918446.56
2454,17,700000,7170,7186,,16,155.74,1614143.0049603174,6918446.56
2455,1,83548000,7170,7858,,688,155.74,3325419.7044334975,6918446.56
2456,15,800000,7170,7199,,29,155.74,4522577.48037889,6918446.56
2457,1,550000,7170,7186,,16,155.74,3325419.7044334975,6918446.56
2458,1,33747600,7170,7892,,722,155.74,3325419.7044334975,6918446.56
2459,13,750000,7172,7248,,76,155.74,7795654.71978022,6918446.56
2460,19,136682000,7173,7983,,810,155.74,6721340.5708154505,6918446.56
2461,19,245000000,7173,8083,,910,155.74,6721340.5708154505,6918446.56
2462,3,900000,7176,7292,,116,155.74,9246769.549865229,6918446.56
2463,2,900000,7177,7200,,23,155.74,2989003.2716499544,6918446.56
2464,2,878000,7178,7220,,42,155.74,2989003.2716499544,6918446.56
2465,15,2000000,7178,7227,,49,155.74,4522577.48037889,6918446.56
2466,17,750000,7180,7194,,14,155.74,1614143.0049603174,6918446.56
2467,24,584700,7184,7192,,8,155.74,23456062.532786883,6918446.56
2468,16,800000,7184,7227,,43,155.74,2465023.1840707962,6918446.56
2469,13,85000000,7185,8522,,1337,155.74,7795654.71978022,6918446.56
2470,16,730000,7186,7208,,22,155.74,2465023.1840707962,6918446.56
2471,15,700000,7186,7239,,53,155.74,4522577.48037889,6918446.56
2472,15,700000,7186,7239,,53,155.74,4522577.48037889,6918446.56
2473,17,1000000,7186,7214,,28,155.74,1614143.0049603174,6918446.56
2474,16,630000,7187,7260,,73,155.74,2465023.1840707962,6918446.56
2475,12,1500000,7191,7239,,48,155.74,7658937.101338432,6918446.56
2476,11,2500000,7191,7234,,43,155.74,1820371.57,6918446.56
2477,2,800000,7192,7221,,29,155.74,2989003.2716499544,6918446.56
2478,16,800000,7192,7233,,41,155.74,2465023.1840707962,6918446.56
2479,17,1000000,7192,7249,,57,155.74,1614143.0049603174,6918446.56
2480,23,750000,7198,7214,,16,155.74,5772926.70157068,6918446.56
2481,17,1400000,7199,7221,,22,155.74,1614143.0049603174,6918446.56
2482,12,1000000,7199,7219,,20,155.74,7658937.101338432,6918446.56
2483,16,1000000,7200,7220,,20,155.74,2465023.1840707962,6918446.56
2484,2,1000000,7201,7218,,17,155.74,2989003.2716499544,6918446.56
2485,16,1400000,7201,7233,,32,155.74,2465023.1840707962,6918446.56
2486,12,800000,7201,7262,,61,155.74,7658937.101338432,6918446.56
2487,12,2100000,7201,7299,,98,155.74,7658937.101338432,6918446.56
2488,11,600000,7204,7232,,28,155.74,1820371.57,6918446.56
2489,16,600000,7204,7317,,113,155.74,2465023.1840707962,6918446.56
2490,13,50000000,7205,8313,,1108,155.74,7795654.71978022,6918446.56
2491,9,600000,7206,7256,,50,155.74,3707403.8834951455,6918446.56
2492,1,800000,7213,7372,,159,155.74,3325419.7044334975,6918446.56
2493,11,1500000,7218,7278,,60,155.74,1820371.57,6918446.56
2494,11,800000,7218,7323,,105,155.74,1820371.57,6918446.56
2495,6,740000,7218,7255,,37,155.74,1124713.2781954887,6918446.56
2496,7,1125000,7219,7234,,15,155.74,3738553.685483871,6918446.56
2497,5,600000,7220,7250,,30,155.74,1400922.5020242915,6918446.56
2498,2,1000000,7220,7270,,50,155.74,2989003.2716499544,6918446.56
2499,5,600000,7220,7250,,30,155.74,1400922.5020242915,6918446.56
2500,24,80000000,7225,8032,,807,155.74,23456062.532786883,6918446.56
2501,11,2000000,7225,7303,,78,155.74,1820371.57,6918446.56
2502,17,60000000,7227,8258,,1031,155.74,1614143.0049603174,6918446.56
2503,2,1000000,7228,7268,,40,155.74,2989003.2716499544,6918446.56
2504,15,600000,7228,7554,,326,155.74,4522577.48037889,6918446.56
2505,15,600000,7228,7494,,266,155.74,4522577.48037889,6918446.56
2506,6,800000,7233,7339,,106,155.74,1124713.2781954887,6918446.56
2507,13,800000,7233,7337,,104,155.74,7795654.71978022,6918446.56
2508,2,2700000,7234,7289,,55,155.74,2989003.2716499544,6918446.56
2509,15,1200000,7234,7268,,34,155.74,4522577.48037889,6918446.56
2510,17,850000,7235,7249,,14,155.74,1614143.0049603174,6918446.56
2511,17,800000,7235,7813,,578,155.74,1614143.0049603174,6918446.56
2512,10,850000,7236,7535,,299,155.74,8282326.220930233,6918446.56
2513,11,1100000,7236,7290,,54,155.74,1820371.57,6918446.56
2514,15,600000,7236,7634,,398,155.74,4522577.48037889,6918446.56
2515,15,600000,7236,7634,,398,155.74,4522577.48037889,6918446.56
2516,24,17000000,7239,7765,,526,155.74,23456062.532786883,6918446.56
2517,5,1000000,7239,7292,,53,155.74,1400922.5020242915,6918446.56
2518,4,110000000,7240,8563,,1323,155.74,4297914.794871795,6918446.56
2519,21,160000000,7240,7859,,619,155.74,17091199.984,6918446.56
2520,17,1000000,7240,7257,,17,155.74,1614143.0049603174,6918446.56
2521,11,750000,7241,7289,,48,155.74,1820371.57,6918446.56
2522,14,550000,7241,7295,,54,155.74,5826416.914893617,6918446.56
2523,9,800000,7241,7277,,36,155.74,3707403.8834951455,6918446.56
2524,17,600000,7243,7278,,35,155.74,1614143.0049603174,6918446.56
2525,23,800000,7243,7285,,42,155.74,5772926.70157068,6918446.56
2526,1,1000000,7245,7264,,19,155.74,3325419.7044334975,6918446.56
2527,8,1263012,7247,8747,,1500,155.74,1501617.2191780822,6918446.56
2528,10,805100,7247,7535,,288,155.74,8282326.220930233,6918446.56
2529,12,1600000,7249,7290,,41,155.74,7658937.101338432,6918446.56
2530,11,3000000,7249,7285,,36,155.74,1820371.57,6918446.56
2531,24,305000000,7249,8633,,1384,155.74,23456062.532786883,6918446.56
2532,2,1544000,7249,7310,,61,155.74,2989003.2716499544,6918446.56
2533,4,800000,7251,7683,,432,155.74,4297914.794871795,6918446.56
2534,10,828800,7260,7310,,50,155.74,8282326.220930233,6918446.56
2535,15,520000,7260,7276,,16,155.74,4522577.48037889,6918446.56
2536,10,6461250,7260,8342,,1082,155.74,8282326.220930233,6918446.56
2537,10,6461250,7260,8326,,1066,155.74,8282326.220930233,6918446.56
2538,10,6461250,7260,8326,,1066,155.74,8282326.220930233,6918446.56
2539,10,5000000,7260,8376,,1116,155.74,8282326.220930233,6918446.56
2540,15,600000,7261,7285,,24,155.74,4522577.48037889,6918446.56
2541,11,1000000,7261,7296,,35,155.74,1820371.57,6918446.56
2542,16,750000,7262,7345,,83,155.74,2465023.1840707962,6918446.56
2543,11,900000,7262,7310,,48,155.74,1820371.57,6918446.56
2544,17,10000000,7264,8391,,1127,155.74,1614143.0049603174,6918446.56
2545,20,25000000,7264,8534,,1270,155.74,7597088.421768707,6918446.56
2546,1,1092000,7267,7298,,31,155.74,3325419.7044334975,6918446.56
2547,1,700000,7267,7312,,45,155.74,3325419.7044334975,6918446.56
2548,10,800000,7268,7284,,16,155.74,8282326.220930233,6918446.56
2549,2,1000000,7268,7359,,91,155.74,2989003.2716499544,6918446.56
2550,1,12800000,7270,7681,,411,155.74,3325419.7044334975,6918446.56
2551,1,800000,7270,7306,,36,155.74,3325419.7044334975,6918446.56
2552,16,850000,7270,7304,,34,155.74,2465023.1840707962,6918446.56
2553,12,1000000,7270,7302,,32,155.74,7658937.101338432,6918446.56
2554,21,133000000,7271,7773,,502,155.74,17091199.984,6918446.56
2555,20,1000000,7273,7444,,171,155.74,7597088.421768707,6918446.56
2556,5,4285714,7276,8524,,1248,155.74,1400922.5020242915,6918446.56
2557,5,4285714,7276,8524,,1248,155.74,1400922.5020242915,6918446.56
2558,5,4285714,7276,8524,,1248,155.74,1400922.5020242915,6918446.56
2559,5,4285714,7276,8524,,1248,155.74,1400922.5020242915,6918446.56
2560,5,4285714,7276,8524,,1248,155.74,1400922.5020242915,6918446.56
2561,5,4285714,7276,8514,,1238,155.74,1400922.5020242915,6918446.56
2562,5,4285714,7276,8524,,1248,155.74,1400922.5020242915,6918446.56
2563,11,550000,7277,7397,,120,155.74,1820371.57,6918446.56
2564,15,650000,7278,7306,,28,155.74,4522577.48037889,6918446.56
2565,4,530000,7278,7443,,165,155.74,4297914.794871795,6918446.56
2566,22,550000,7278,7299,,21,155.74,2904103.2512077293,6918446.56
2567,24,220000000,7278,8367,,1089,155.74,23456062.532786883,6918446.56
2568,22,650000,7281,7422,,141,155.74,2904103.2512077293,6918446.56
2569,1,800000,7284,7302,,18,155.74,3325419.7044334975,6918446.56
2570,16,800000,7285,7362,,77,155.74,2465023.1840707962,6918446.56
2571,17,600000,7288,7369,,81,155.74,1614143.0049603174,6918446.56
2572,13,6000000,7288,7628,,340,155.74,7795654.71978022,6918446.56
2573,15,45369020,7290,8108,,818,155.74,4522577.48037889,6918446.56
2574,12,69000000,7292,7905,,613,155.74,7658937.101338432,6918446.56
2575,22,10681500,7294,7900,,606,155.74,2904103.2512077293,6918446.56
2576,24,4428000,7295,8006,,711,155.74,23456062.532786883,6918446.56
2577,13,35000000,7295,8048,,753,155.74,7795654.71978022,6918446.56
2578,14,900000,7296,7648,,352,155.74,5826416.914893617,6918446.56
2579,12,600000,7296,7313,,17,155.74,7658937.101338432,6918446.56
2580,16,700000,7296,7598,,302,155.74,2465023.1840707962,6918446.56
2581,12,600000,7296,7313,,17,155.74,7658937.101338432,6918446.56
2582,15,750000,7297,7339,,42,155.74,4522577.48037889,6918446.56
2583,23,600000,7298,7563,,265,155.74,5772926.70157068,6918446.56
2584,1,63000000,7299,7765,,466,155.74,3325419.7044334975,6918446.56
2585,14,600000,7299,7450,,151,155.74,5826416.914893617,6918446.56
2586,14,600000,7299,7465,,166,155.74,5826416.914893617,6918446.56
2587,11,800000,7299,7436,,137,155.74,1820371.57,6918446.56
2588,13,1200000,7301,7372,,71,155.74,7795654.71978022,6918446.56
2589,2,750000,7302,7382,,80,155.74,2989003.2716499544,6918446.56
2590,12,4000000,7303,7414,,111,155.74,7658937.101338432,6918446.56
2591,5,995000,7303,7326,,23,155.74,1400922.5020242915,6918446.56
2592,19,750000,7304,7333,,29,155.74,6721340.5708154505,6918446.56
2593,12,650000,7304,7375,,71,155.74,7658937.101338432,6918446.56
2594,11,1000000,7305,7621,,316,155.74,1820371.57,6918446.56
2595,12,1000000,7306,7548,,242,155.74,7658937.101338432,6918446.56
2596,1,700000,7306,7459,,153,155.74,3325419.7044334975,6918446.56
2597,2,600000,7310,7411,,101,155.74,2989003.2716499544,6918446.56
2598,23,1000000,7312,8887,,1575,155.74,5772926.70157068,6918446.56
2599,2,800000,7313,7505,,192,155.74,2989003.2716499544,6918446.56
2600,12,1000000,7313,7347,,34,155.74,7658937.101338432,6918446.56
2601,17,850000,7317,7334,,17,155.74,1614143.0049603174,6918446.56
2602,15,600000,7318,7348,,30,155.74,4522577.48037889,6918446.56
2603,13,600000,7319,8073,,754,155.74,7795654.71978022,6918446.56
2604,24,18872000,7319,7807,,488,155.74,23456062.532786883,6918446.56
2605,2,850000,7319,7382,,63,155.74,2989003.2716499544,6918446.56
2606,16,905750,7320,7340,,20,155.74,2465023.1840707962,6918446.56
2607,4,850000,7320,7351,,31,155.74,4297914.794871795,6918446.56
2608,19,1750000,7321,7338,,17,155.74,6721340.5708154505,6918446.56
2609,23,6000000,7324,7696,,372,155.74,5772926.70157068,6918446.56
2610,2,700000,7325,7351,,26,155.74,2989003.2716499544,6918446.56
2611,12,1800000,7327,7562,,235,155.74,7658937.101338432,6918446.56
2612,1,800000,7327,7346,,19,155.74,3325419.7044334975,6918446.56
2613,13,50000000,7330,8165,,835,155.74,7795654.71978022,6918446.56
2614,12,1400000,7330,7348,,18,155.74,7658937.101338432,6918446.56
2615,18,800000,7332,7367,,35,155.74,8584355.493548388,6918446.56
2616,6,900000,7333,7355,,22,155.74,1124713.2781954887,6918446.56
2617,11,1000000,7334,7361,,27,155.74,1820371.57,6918446.56
2618,17,1000000,7334,7351,,17,155.74,1614143.0049603174,6918446.56
2619,7,750000,7334,7360,,26,155.74,3738553.685483871,6918446.56
2620,2,598000,7340,7439,,99,155.74,2989003.2716499544,6918446.56
2621,2,572000,7340,7439,,99,155.74,2989003.2716499544,6918446.56
2622,2,600000,7341,7439,,98,155.74,2989003.2716499544,6918446.56
2623,2,624000,7341,7542,,201,155.74,2989003.2716499544,6918446.56
2624,2,590000,7345,7439,,94,155.74,2989003.2716499544,6918446.56
2625,1,700000,7339,7374,,35,155.74,3325419.7044334975,6918446.56
2626,24,5000000,7340,7383,,43,155.74,23456062.532786883,6918446.56
2627,17,5600000,7340,8305,,965,155.74,1614143.0049603174,6918446.56
2628,22,650000,7341,7372,,31,155.74,2904103.2512077293,6918446.56
2629,24,750000,7341,7348,,7,155.74,23456062.532786883,6918446.56
2630,17,650000,7341,7425,,84,155.74,1614143.0049603174,6918446.56
2631,15,1000000,7345,7368,,23,155.74,4522577.48037889,6918446.56
2632,2,525000,7347,7464,,117,155.74,2989003.2716499544,6918446.56
2633,4,800000,7347,7379,,32,155.74,4297914.794871795,6918446.56
2634,12,206000000,7348,8605,,1257,155.74,7658937.101338432,6918446.56
2635,16,800000,7348,7390,,42,155.74,2465023.1840707962,6918446.56
2636,24,58772000,7352,7887,,535,155.74,23456062.532786883,6918446.56
2637,3,620259,7353,7367,,14,155.74,9246769.549865229,6918446.56
2638,18,90000000,7355,8584,,1229,155.74,8584355.493548388,6918446.56
2639,16,850000,7358,7451,,93,155.74,2465023.1840707962,6918446.56
2640,1,106000000,7360,8509,,1149,155.74,3325419.7044334975,6918446.56
2641,1,41000000,7360,8430,,1070,155.74,3325419.7044334975,6918446.56
2642,16,800000,7361,7415,,54,155.74,2465023.1840707962,6918446.56
2643,2,750000,7361,7422,,61,155.74,2989003.2716499544,6918446.56
2644,12,750000,7361,7459,,98,155.74,7658937.101338432,6918446.56
2645,2,750000,7362,7425,,63,155.74,2989003.2716499544,6918446.56
2646,12,2000000,7366,7470,,104,155.74,7658937.101338432,6918446.56
2647,5,700000,7367,7954,,587,155.74,1400922.5020242915,6918446.56
2648,24,800000,7367,7415,,48,155.74,23456062.532786883,6918446.56
2649,6,800000,7367,7386,,19,155.74,1124713.2781954887,6918446.56
2650,16,150000000,7368,8079,,711,155.74,2465023.1840707962,6918446.56
2651,12,800000,7369,7437,,68,155.74,7658937.101338432,6918446.56
2652,11,3000000,7372,7401,,29,155.74,1820371.57,6918446.56
2653,4,150000000,7373,8788,,1415,155.74,4297914.794871795,6918446.56
2654,20,50000000,7374,8173,,799,155.74,7597088.421768707,6918446.56
2655,24,18000000,7374,7443,,69,155.74,23456062.532786883,6918446.56
2656,18,1000000,7374,7591,,217,155.74,8584355.493548388,6918446.56
2657,12,25000000,7375,8527,,1152,155.74,7658937.101338432,6918446.56
2658,12,102000000,7376,8594,,1218,155.74,7658937.101338432,6918446.56
2659,3,40000000,7376,8237,,861,155.74,9246769.549865229,6918446.56
2660,23,100000000,7379,8886,,1507,155.74,5772926.70157068,6918446.56
2661,23,800000,7379,7508,,129,155.74,5772926.70157068,6918446.56
2662,24,2500000,7381,7414,,33,155.74,23456062.532786883,6918446.56
2663,3,2000000,7381,7453,,72,155.74,9246769.549865229,6918446.56
2664,12,550000,7381,7451,,70,155.74,7658937.101338432,6918446.56
2665,12,800000,7381,7418,,37,155.74,7658937.101338432,6918446.56
2666,24,100000000,7382,8430,,1048,155.74,23456062.532786883,6918446.56
2667,11,600000,7383,7407,,24,155.74,1820371.57,6918446.56
2668,21,100000000,7383,8615,,1232,155.74,17091199.984,6918446.56
2669,17,900000,7383,7408,,25,155.74,1614143.0049603174,6918446.56
2670,22,800000,7386,7530,,144,155.74,2904103.2512077293,6918446.56
2671,15,550000,7394,7670,,276,155.74,4522577.48037889,6918446.56
2672,2,750000,7401,7422,,21,152.24,2989003.2716499544,6303424.81
2673,23,900000,7407,7684,,277,152.24,5772926.70157068,6303424.81
2674,24,138000000,7411,8642,,1231,152.24,23456062.532786883,6303424.81
2675,17,2000000,7416,7445,,29,152.24,1614143.0049603174,6303424.81
2676,2,950000,7416,7809,,393,152.24,2989003.2716499544,6303424.81
2677,3,600000000,7417,7894,,477,152.24,9246769.549865229,6303424.81
2678,17,10000000,7421,7542,,121,152.24,1614143.0049603174,6303424.81
2679,11,750000,7424,7466,,42,152.24,1820371.57,6303424.81
2680,2,800000,7425,7464,,39,152.24,2989003.2716499544,6303424.81
2681,18,900000,7428,7506,,78,152.24,8584355.493548388,6303424.81
2682,17,750000,7428,7460,,32,152.24,1614143.0049603174,6303424.81
2683,5,600000,7428,7452,,24,152.24,1400922.5020242915,6303424.81
2684,17,800000,7429,7449,,20,152.24,1614143.0049603174,6303424.81
2685,1,1500000,7429,7835,,406,152.24,3325419.7044334975,6303424.81
2686,0,625000,7430,7452,,22,152.24,8418173.322222222,6303424.81
2687,2,800000,7431,7901,,470,152.24,2989003.2716499544,6303424.81
2688,2,800000,7431,7922,,491,152.24,2989003.2716499544,6303424.81
2689,2,800000,7431,7922,,491,152.24,2989003.2716499544,6303424.81
2690,2,800000,7431,7922,,491,152.24,2989003.2716499544,6303424.81
2691,2,3000000,7431,7549,,118,152.24,2989003.2716499544,6303424.81
2692,2,800000,7431,7922,,491,152.24,2989003.2716499544,6303424.81
2693,2,800000,7431,7922,,491,152.24,2989003.2716499544,6303424.81
2694,2,800000,7431,7922,,491,152.24,2989003.2716499544,6303424.81
2695,2,800000,7432,7922,,490,152.24,2989003.2716499544,6303424.81
2696,2,800000,7432,7922,,490,152.24,2989003.2716499544,6303424.81
2697,2,800000,7432,7901,,469,152.24,2989003.2716499544,6303424.81
2698,2,800000,7432,7901,,469,152.24,2989003.2716499544,6303424.81
2699,22,102278659,7432,8704,,1272,152.24,2904103.2512077293,6303424.81
2700,16,1400000,7436,7549,,113,152.24,2465023.1840707962,6303424.81
2701,15,600000,7437,7453,,16,152.24,4522577.48037889,6303424.81
2702,13,1000000,7437,7624,,187,152.24,7795654.71978022,6303424.81
2703,17,1000000,7437,7458,,21,152.24,1614143.0049603174,6303424.81
2704,14,600000,7438,7541,,103,152.24,5826416.914893617,6303424.81
2705,23,800000,7438,7471,,33,152.24,5772926.70157068,6303424.81
2706,16,1200000,7443,7534,,91,152.24,2465023.1840707962,6303424.81
2707,15,1200000,7444,7879,,435,152.24,4522577.48037889,6303424.81
2708,15,1200000,7444,7879,,435,152.24,4522577.48037889,6303424.81
2709,17,1400000,7451,7702,,251,152.24,1614143.0049603174,6303424.81
2710,12,750000,7452,7512,,60,152.24,7658937.101338432,6303424.81
2711,1,1200000,7452,7540,,88,152.24,3325419.7044334975,6303424.81
2712,24,1100000,7453,7547,,94,152.24,23456062.532786883,6303424.81
2713,2,600000,7453,7526,,73,152.24,2989003.2716499544,6303424.81
2714,13,600000,7456,7527,,71,152.24,7795654.71978022,6303424.81
2715,13,600000,7457,7527,,70,152.24,7795654.71978022,6303424.81
2716,2,600000,7457,7528,,71,152.24,2989003.2716499544,6303424.81
2717,1,990000,7457,7701,,244,152.24,3325419.7044334975,6303424.81
2718,11,1000000,7458,7571,,113,152.24,1820371.57,6303424.81
2719,23,750000,7458,7688,,230,152.24,5772926.70157068,6303424.81
2720,9,800000,7459,7523,,64,152.24,3707403.8834951455,6303424.81
2721,5,11250440,7460,8608,,1148,152.24,1400922.5020242915,6303424.81
2722,3,2500000,7463,7908,,445,152.24,9246769.549865229,6303424.81
2723,2,750000,7463,7613,,150,152.24,2989003.2716499544,6303424.81
2724,17,930000,7464,7569,,105,152.24,1614143.0049603174,6303424.81
2725,11,750000,7464,7528,,64,152.24,1820371.57,6303424.81
2726,17,800000,7465,7568,,103,152.24,1614143.0049603174,6303424.81
2727,4,1600000,7465,7562,,97,152.24,4297914.794871795,6303424.81
2728,2,750000,7465,7537,,72,152.24,2989003.2716499544,6303424.81
2729,17,650000,7470,7612,,142,152.24,1614143.0049603174,6303424.81
2730,2,900000,7491,7555,,64,152.24,2989003.2716499544,6303424.81
2731,22,750000,7493,7593,,100,152.24,2904103.2512077293,6303424.81
2732,16,600000,7493,7551,,58,152.24,2465023.1840707962,6303424.81
2733,8,980000,7494,7529,,35,152.24,1501617.2191780822,6303424.81
2734,16,1000000,7499,7586,,87,152.24,2465023.1840707962,6303424.81
2735,9,995000,7499,7536,,37,152.24,3707403.8834951455,6303424.81
2736,14,518800,7500,7530,,30,152.24,5826416.914893617,6303424.81
2737,1,800000,7501,7515,,14,152.24,3325419.7044334975,6303424.81
2738,21,95000000,7505,8544,,1039,152.24,17091199.984,6303424.81
2739,11,3000000,7505,7536,,31,152.24,1820371.57,6303424.81
2740,1,590000,7506,7561,,55,152.24,3325419.7044334975,6303424.81
2741,17,650000,7507,7612,,105,152.24,1614143.0049603174,6303424.81
2742,2,700000,7512,7535,,23,152.24,2989003.2716499544,6303424.81
2743,2,700000,7512,7669,,157,152.24,2989003.2716499544,6303424.81
2744,10,600000,7513,7544,,31,152.24,8282326.220930233,6303424.81
2745,17,800000,7515,7576,,61,152.24,1614143.0049603174,6303424.81
2746,24,600000,7515,7585,,70,152.24,23456062.532786883,6303424.81
2747,15,1500000,7516,7689,,173,152.24,4522577.48037889,6303424.81
2748,11,750000,7521,7568,,47,152.24,1820371.57,6303424.81
2749,16,750000,7522,7547,,25,152.24,2465023.1840707962,6303424.81
2750,11,750000,7523,7535,,12,152.24,1820371.57,6303424.81
2751,17,1500000,7526,7683,,157,152.24,1614143.0049603174,6303424.81
2752,11,1000000,7527,7603,,76,152.24,1820371.57,6303424.81
2753,13,1000000,7527,7562,,35,152.24,7795654.71978022,6303424.81
2754,12,6000000,7534,8367,,833,152.24,7658937.101338432,6303424.81
2755,12,6000000,7534,8367,,833,152.24,7658937.101338432,6303424.81
2756,12,1500000,7534,7589,,55,152.24,7658937.101338432,6303424.81
2757,16,800000,7536,7557,,21,152.24,2465023.1840707962,6303424.81
2758,15,679500,7536,7572,,36,152.24,4522577.48037889,6303424.81
2759,15,576560,7537,7568,,31,152.24,4522577.48037889,6303424.81
2760,9,32000000,7541,8557,,1016,152.24,3707403.8834951455,6303424.81
2761,24,2000000,7542,7555,,13,152.24,23456062.532786883,6303424.81
2762,16,980000,7544,7618,,74,152.24,2465023.1840707962,6303424.81
2763,2,600000,7547,7606,,59,152.24,2989003.2716499544,6303424.81
2764,2,600000,7547,7621,,74,152.24,2989003.2716499544,6303424.81
2765,23,25000000,7547,8844,,1297,152.24,5772926.70157068,6303424.81
2766,15,700000,7549,7576,,27,152.24,4522577.48037889,6303424.81
2767,0,668343,7549,7599,,50,152.24,8418173.322222222,6303424.81
2768,0,583026,7550,7592,,42,152.24,8418173.322222222,6303424.81
2769,17,700000,7550,7606,,56,152.24,1614143.0049603174,6303424.81
2770,15,700000,7550,7576,,26,152.24,4522577.48037889,6303424.81
2771,18,750000,7554,7583,,29,152.24,8584355.493548388,6303424.81
2772,17,663481,7554,7618,,64,152.24,1614143.0049603174,6303424.81
2773,16,750000,7556,7575,,19,152.24,2465023.1840707962,6303424.81
2774,22,516555,7556,7585,,29,152.24,2904103.2512077293,6303424.81
2775,16,886000,7557,7753,,196,152.24,2465023.1840707962,6303424.81
2776,9,600000,7557,7635,,78,152.24,3707403.8834951455,6303424.81
2777,2,1410000,7558,7641,,83,152.24,2989003.2716499544,6303424.81
2778,17,8000000,7558,8415,,857,152.24,1614143.0049603174,6303424.81
2779,15,650000,7561,7605,,44,152.24,4522577.48037889,6303424.81
2780,0,564700,7562,7619,,57,152.24,8418173.322222222,6303424.81
2781,12,650000,7563,7590,,27,152.24,7658937.101338432,6303424.81
2782,13,1000000,7563,7590,,27,152.24,7795654.71978022,6303424.81
2783,16,1000000,7565,7638,,73,152.24,2465023.1840707962,6303424.81
2784,15,625000,7565,7901,,336,152.24,4522577.48037889,6303424.81
2785,20,5000000,7569,8062,,493,152.24,7597088.421768707,6303424.81
2786,20,5000000,7569,8062,,493,152.24,7597088.421768707,6303424.81
2787,20,5000000,7569,8062,,493,152.24,7597088.421768707,6303424.81
2788,20,8000000,7569,8062,,493,152.24,7597088.421768707,6303424.81
2789,11,1000000,7570,8046,,476,152.24,1820371.57,6303424.81
2790,20,511029,7571,7733,,162,152.24,7597088.421768707,6303424.81
2791,11,2302000,7572,7620,,48,152.24,1820371.57,6303424.81
2792,20,950000,7575,7646,,71,152.24,7597088.421768707,6303424.81
2793,17,80000000,7576,8576,,1000,152.24,1614143.0049603174,6303424.81
2794,13,1000000,7582,7597,,15,152.24,7795654.71978022,6303424.81
2795,22,20000000,7584,8341,,757,152.24,2904103.2512077293,6303424.81
2796,15,600000,7585,7603,,18,152.24,4522577.48037889,6303424.81
2797,4,800000,7585,7662,,77,152.24,4297914.794871795,6303424.81
2798,20,600000,7590,7620,,30,152.24,7597088.421768707,6303424.81
2799,17,700000,7596,7617,,21,152.24,1614143.0049603174,6303424.81
2800,10,900000,7598,7618,,20,152.24,8282326.220930233,6303424.81
2801,11,1000000,7598,7634,,36,152.24,1820371.57,6303424.81
2802,15,110522000,7599,8062,,463,152.24,4522577.48037889,6303424.81
2803,22,1100000,7599,7711,,112,152.24,2904103.2512077293,6303424.81
2804,20,120000000,7600,8657,,1057,152.24,7597088.421768707,6303424.81
2805,20,80000000,7600,8654,,1054,152.24,7597088.421768707,6303424.81
2806,19,30000000,7600,8254,,654,152.24,6721340.5708154505,6303424.81
2807,11,2200000,7603,7668,,65,152.24,1820371.57,6303424.81
2808,2,550000,7603,7851,,248,152.24,2989003.2716499544,6303424.81
2809,2,1200000,7605,7696,,91,152.24,2989003.2716499544,6303424.81
2810,1,600000,7607,7653,,46,152.24,3325419.7044334975,6303424.81
2811,21,590000,7611,7704,,93,152.24,17091199.984,6303424.81
2812,12,50000000,7614,8482,,868,152.24,7658937.101338432,6303424.81
2813,17,1000000,7614,7689,,75,152.24,1614143.0049603174,6303424.81
2814,5,800000,7624,7704,,80,152.24,1400922.5020242915,6303424.81
2815,2,1500000,7624,7838,,214,152.24,2989003.2716499544,6303424.81
2816,17,8000000,7625,7989,,364,152.24,1614143.0049603174,6303424.81
2817,12,40000000,7625,8697,,1072,152.24,7658937.101338432,6303424.81
2818,20,8600000,7626,8086,,460,152.24,7597088.421768707,6303424.81
2819,16,800000,7626,7660,,34,152.24,2465023.1840707962,6303424.81
2820,11,800000,7626,7673,,47,152.24,1820371.57,6303424.81
2821,17,30000000,7627,8515,,888,152.24,1614143.0049603174,6303424.81
2822,16,1000000,7627,7670,,43,152.24,2465023.1840707962,6303424.81
2823,15,20000000,7628,8802,,1174,152.24,4522577.48037889,6303424.81
2824,5,650000,7628,8058,,430,152.24,1400922.5020242915,6303424.81
2825,12,750000,7628,8355,,727,152.24,7658937.101338432,6303424.81
2826,9,547200,7629,7653,,24,152.24,3707403.8834951455,6303424.81
2827,12,1000000,7632,7829,,197,152.24,7658937.101338432,6303424.81
2828,15,600000,7633,7659,,26,152.24,4522577.48037889,6303424.81
2829,14,850000,7633,7688,,55,152.24,5826416.914893617,6303424.81
2830,15,20000000,7634,8821,,1187,152.24,4522577.48037889,6303424.81
2831,15,20000000,7634,8802,,1168,152.24,4522577.48037889,6303424.81
2832,15,20000000,7634,8802,,1168,152.24,4522577.48037889,6303424.81
2833,15,20000000,7634,8802,,1168,152.24,4522577.48037889,6303424.81
2834,2,750000,7639,7823,,184,152.24,2989003.2716499544,6303424.81
2835,21,100000000,7639,8458,,819,152.24,17091199.984,6303424.81
2836,2,750000,7639,7823,,184,152.24,2989003.2716499544,6303424.81
2837,18,600000,7639,7690,,51,152.24,8584355.493548388,6303424.81
2838,13,550000,7648,7683,,35,152.24,7795654.71978022,6303424.81
2839,17,700000,7649,7667,,18,152.24,1614143.0049603174,6303424.81
2840,15,600000,7652,7696,,44,152.24,4522577.48037889,6303424.81
2841,15,800000,7652,7724,,72,152.24,4522577.48037889,6303424.81
2842,11,60000000,7653,8131,,478,152.24,1820371.57,6303424.81
2843,19,1000000,7654,7681,,27,152.24,6721340.5708154505,6303424.81
2844,14,2400000,7654,7697,,43,152.24,5826416.914893617,6303424.81
2845,14,2400000,7654,7697,,43,152.24,5826416.914893617,6303424.81
2846,14,2400000,7654,7697,,43,152.24,5826416.914893617,6303424.81
2847,14,1800000,7654,7697,,43,152.24,5826416.914893617,6303424.81
2848,14,2400000,7654,7698,,44,152.24,5826416.914893617,6303424.81
2849,14,2400000,7654,7697,,43,152.24,5826416.914893617,6303424.81
2850,11,900000,7654,7697,,43,152.24,1820371.57,6303424.81
2851,17,1000000,7655,7670,,15,152.24,1614143.0049603174,6303424.81
2852,17,600000,7656,7674,,18,152.24,1614143.0049603174,6303424.81
2853,16,2500000,7659,7695,,36,152.24,2465023.1840707962,6303424.81
2854,17,700000,7662,7773,,111,152.24,1614143.0049603174,6303424.81
2855,21,750000,7663,7801,,138,152.24,17091199.984,6303424.81
2856,21,750000,7663,7738,,75,152.24,17091199.984,6303424.81
2857,11,3000000,7663,7730,,67,152.24,1820371.57,6303424.81
2858,17,900000,7668,7711,,43,152.24,1614143.0049603174,6303424.81
2859,1,1000000,7668,7723,,55,152.24,3325419.7044334975,6303424.81
2860,22,700000,7668,7780,,112,152.24,2904103.2512077293,6303424.81
2861,2,506250,7670,7698,,28,152.24,2989003.2716499544,6303424.81
2862,2,527400,7670,7698,,28,152.24,2989003.2716499544,6303424.81
2863,2,506250,7670,7698,,28,152.24,2989003.2716499544,6303424.81
2864,2,500550,7670,7698,,28,152.24,2989003.2716499544,6303424.81
2865,12,1000000,7670,7723,,53,152.24,7658937.101338432,6303424.81
2866,20,900000,7673,7750,,77,152.24,7597088.421768707,6303424.81
2867,15,2000000,7674,8381,,707,152.24,4522577.48037889,6303424.81
2868,2,900000,7675,7789,,114,152.24,2989003.2716499544,6303424.81
2869,9,750000,7677,7736,,59,152.24,3707403.8834951455,6303424.81
2870,17,700000,7683,7703,,20,152.24,1614143.0049603174,6303424.81
2871,2,500550,7684,7725,,41,152.24,2989003.2716499544,6303424.81
2872,2,506250,7684,7725,,41,152.24,2989003.2716499544,6303424.81
2873,15,1200000,7684,7743,,59,152.24,4522577.48037889,6303424.81
2874,4,900000,7687,7717,,30,152.24,4297914.794871795,6303424.81
2875,3,1450000,7689,7787,,98,152.24,9246769.549865229,6303424.81
2876,13,800000,7689,7739,,50,152.24,7795654.71978022,6303424.81
2877,19,100000000,7691,8741,,1050,152.24,6721340.5708154505,6303424.81
2878,15,650000,7694,8081,,387,152.24,4522577.48037889,6303424.81
2879,6,750000,7694,8383,,689,152.24,1124713.2781954887,6303424.81
2880,11,1500000,7695,7778,,83,152.24,1820371.57,6303424.81
2881,2,900000,7696,7715,,19,152.24,2989003.2716499544,6303424.81
2882,15,15000000,7697,8570,,873,152.24,4522577.48037889,6303424.81
2883,6,700000,7697,7718,,21,152.24,1124713.2781954887,6303424.81
2884,19,850000,7703,7794,,91,152.24,6721340.5708154505,6303424.81
2885,11,750000,7704,7934,,230,152.24,1820371.57,6303424.81
2886,15,30000000,7708,8292,,584,152.24,4522577.48037889,6303424.81
2887,11,982000,7708,7822,,114,152.24,1820371.57,6303424.81
2888,22,700000,7709,7801,,92,152.24,2904103.2512077293,6303424.81
2889,22,700000,7709,7785,,76,152.24,2904103.2512077293,6303424.81
2890,12,1000000,7711,7730,,19,152.24,7658937.101338432,6303424.81
2891,20,56436000,7715,8412,,697,152.24,7597088.421768707,6303424.81
2892,20,56436000,7715,8396,,681,152.24,7597088.421768707,6303424.81
2893,2,750000,7716,7732,,16,152.24,2989003.2716499544,6303424.81
2894,21,130000000,7717,8682,,965,152.24,17091199.984,6303424.81
2895,15,850000,7717,7743,,26,152.24,4522577.48037889,6303424.81
2896,22,550000,7717,7746,,29,152.24,2904103.2512077293,6303424.81
2897,22,800000,7718,7771,,53,152.24,2904103.2512077293,6303424.81
2898,6,640000,7718,7774,,56,152.24,1124713.2781954887,6303424.81
2899,17,750000,7719,7782,,63,152.24,1614143.0049603174,6303424.81
2900,19,1000000,7724,7796,,72,152.24,6721340.5708154505,6303424.81
2901,15,556000,7725,7795,,70,152.24,4522577.48037889,6303424.81
2902,15,556000,7725,7821,,96,152.24,4522577.48037889,6303424.81
2903,16,1100000,7726,7789,,63,152.24,2465023.1840707962,6303424.81
2904,2,600000,7726,7789,,63,152.24,2989003.2716499544,6303424.81
2905,2,800000,7729,7780,,51,152.24,2989003.2716499544,6303424.81
2906,2,600000,7729,7786,,57,152.24,2989003.2716499544,6303424.81
2907,11,50000000,7730,8657,,927,152.24,1820371.57,6303424.81
2908,12,13500000,7730,8152,,422,152.24,7658937.101338432,6303424.81
2909,18,1000000,7731,7785,,54,152.24,8584355.493548388,6303424.81
2910,1,800000,7731,7792,,61,152.24,3325419.7044334975,6303424.81
2911,6,920000,7731,7829,,98,152.24,1124713.2781954887,6303424.81
2912,6,1400000,7731,7831,,100,152.24,1124713.2781954887,6303424.81
2913,3,3500000,7733,7773,,40,152.24,9246769.549865229,6303424.81
2914,14,70000000,7737,8054,,317,152.24,5826416.914893617,6303424.81
2915,17,900000,7738,7842,,104,152.24,1614143.0049603174,6303424.81
2916,11,2200000,7738,7794,,56,152.24,1820371.57,6303424.81
2917,3,50000000,7739,8864,,1125,152.24,9246769.549865229,6303424.81
2918,11,750000,7739,7795,,56,152.24,1820371.57,6303424.81
2919,2,800000,7743,7913,,170,152.24,2989003.2716499544,6303424.81
2920,18,900000,7743,7788,,45,152.24,8584355.493548388,6303424.81
2921,17,1000000,7744,7774,,30,152.24,1614143.0049603174,6303424.81
2922,2,900000,7744,7788,,44,152.24,2989003.2716499544,6303424.81
2923,16,750000,7744,7824,,80,152.24,2465023.1840707962,6303424.81
2924,16,2100000,7745,7766,,21,152.24,2465023.1840707962,6303424.81
2925,17,900000,7745,7781,,36,152.24,1614143.0049603174,6303424.81
2926,17,750000,7746,7802,,56,152.24,1614143.0049603174,6303424.81
2927,17,800000,7747,7816,,69,152.24,1614143.0049603174,6303424.81
2928,3,4000000,7747,7871,,124,152.24,9246769.549865229,6303424.81
2929,3,1456000,7747,7772,,25,152.24,9246769.549865229,6303424.81
2930,1,600000,7747,7788,,41,152.24,3325419.7044334975,6303424.81
2931,2,850000,7750,7786,,36,152.24,2989003.2716499544,6303424.81
2932,24,235000000,7750,8664,,914,152.24,23456062.532786883,6303424.81
2933,16,700000,7750,7841,,91,152.24,2465023.1840707962,6303424.81
2934,2,1000000,7750,7897,,147,152.24,2989003.2716499544,6303424.81
2935,11,1500000,7751,7772,,21,152.24,1820371.57,6303424.81
2936,2,1100000,7751,7873,,122,152.24,2989003.2716499544,6303424.81
2937,2,1100000,7751,7873,,122,152.24,2989003.2716499544,6303424.81
2938,16,1000000,7751,7792,,41,152.24,2465023.1840707962,6303424.81
2939,4,900000,7751,7823,,72,152.24,4297914.794871795,6303424.81
2940,24,100000000,7752,8873,,1121,152.24,23456062.532786883,6303424.81
2941,11,1200000,7752,7871,,119,152.24,1820371.57,6303424.81
2942,11,1400000,7752,7774,,22,152.24,1820371.57,6303424.81
2943,4,950000,7752,7792,,40,152.24,4297914.794871795,6303424.81
2944,14,130000000,7753,8580,,827,152.24,5826416.914893617,6303424.81
2945,17,1000000,7753,7789,,36,152.24,1614143.0049603174,6303424.81
2946,11,850000,7753,7773,,20,152.24,1820371.57,6303424.81
2947,3,100000000,7753,8345,,592,152.24,9246769.549865229,6303424.81
2948,22,750000,7758,7985,,227,152.24,2904103.2512077293,6303424.81
2949,22,750000,7759,7878,,119,152.24,2904103.2512077293,6303424.81
2950,19,990000,7759,7850,,91,152.24,6721340.5708154505,6303424.81
2951,11,2000000,7759,7810,,51,152.24,1820371.57,6303424.81
2952,22,1100000,7764,7814,,50,120.16,2904103.2512077293,3586324.4
2953,11,1000000,7764,7886,,122,120.16,1820371.57,3586324.4
2954,12,10000000,7765,8614,,849,120.16,7658937.101338432,3586324.4
2955,3,2500000,7767,7871,,104,120.16,9246769.549865229,3586324.4
2956,7,570000,7773,8024,,251,120.16,3738553.685483871,3586324.4
2957,17,1550000,7774,7820,,46,120.16,1614143.0049603174,3586324.4
2958,5,729000,7778,7901,,123,120.16,1400922.5020242915,3586324.4
2959,6,750000,7778,7824,,46,120.16,1124713.2781954887,3586324.4
2960,15,950000,7778,8011,,233,120.16,4522577.48037889,3586324.4
2961,17,950000,7778,7800,,22,120.16,1614143.0049603174,3586324.4
2962,17,1000000,7779,7857,,78,120.16,1614143.0049603174,3586324.4
2963,17,850000,7779,7814,,35,120.16,1614143.0049603174,3586324.4
2964,15,700000,7780,7796,,16,120.16,4522577.48037889,3586324.4
2965,1,2000000,7781,7824,,43,120.16,3325419.7044334975,3586324.4
2966,17,600000,7781,7814,,33,120.16,1614143.0049603174,3586324.4
2967,16,850000,7782,7887,,105,120.16,2465023.1840707962,3586324.4
2968,17,600000,7785,7829,,44,120.16,1614143.0049603174,3586324.4
2969,17,600000,7785,7829,,44,120.16,1614143.0049603174,3586324.4
2970,17,700000,7786,7858,,72,120.16,1614143.0049603174,3586324.4
2971,11,900000,7788,7808,,20,120.16,1820371.57,3586324.4
2972,23,800000,7788,7820,,32,120.16,5772926.70157068,3586324.4
2973,12,700000,7789,7848,,59,120.16,7658937.101338432,3586324.4
2974,9,52000000,7792,8404,,612,120.16,3707403.8834951455,3586324.4
2975,4,900000,7792,7883,,91,120.16,4297914.794871795,3586324.4
2976,3,950000,7793,7831,,38,120.16,9246769.549865229,3586324.4
2977,22,850000,7794,7857,,63,120.16,2904103.2512077293,3586324.4
2978,11,5000000,7795,8179,,384,120.16,1820371.57,3586324.4
2979,5,1000000,7795,7851,,56,120.16,1400922.5020242915,3586324.4
2980,17,700000,7796,7814,,18,120.16,1614143.0049603174,3586324.4
2981,12,2000000,7799,7843,,44,120.16,7658937.101338432,3586324.4
2982,17,1290000,7799,7858,,59,120.16,1614143.0049603174,3586324.4
2983,21,90000000,7799,8741,,942,120.16,17091199.984,3586324.4
2984,6,1200000,7800,8201,,401,120.16,1124713.2781954887,3586324.4
2985,3,750000,7801,7823,,22,120.16,9246769.549865229,3586324.4
2986,17,1500000,7802,7821,,19,120.16,1614143.0049603174,3586324.4
2987,2,776000,7803,7849,,46,120.16,2989003.2716499544,3586324.4
2988,14,700000,7803,7821,,18,120.16,5826416.914893617,3586324.4
2989,6,800000,7803,8023,,220,120.16,1124713.2781954887,3586324.4
2990,10,1000000,7807,7866,,59,120.16,8282326.220930233,3586324.4
2991,21,150000000,7807,8479,,672,120.16,17091199.984,3586324.4
2992,9,1000000,7807,7933,,126,120.16,3707403.8834951455,3586324.4
2993,4,2100000,7808,8031,,223,120.16,4297914.794871795,3586324.4
2994,2,1500000,7808,8473,,665,120.16,2989003.2716499544,3586324.4
2995,22,675000,7808,7970,,162,120.16,2904103.2512077293,3586324.4
2996,12,1500000,7810,7862,,52,120.16,7658937.101338432,3586324.4
2997,15,1000000,7813,8324,,511,120.16,4522577.48037889,3586324.4
2998,3,700000,7814,7838,,24,120.16,9246769.549865229,3586324.4
2999,14,622590,7815,7857,,42,120.16,5826416.914893617,3586324.4
3000,11,850000,7817,7862,,45,120.16,1820371.57,3586324.4
3001,16,1385600,7822,7892,,70,120.16,2465023.1840707962,3586324.4
3002,9,1000000,7823,7927,,104,120.16,3707403.8834951455,3586324.4
3003,17,950000,7823,7838,,15,120.16,1614143.0049603174,3586324.4
3004,5,550000,7824,7971,,147,120.16,1400922.5020242915,3586324.4
3005,6,1000000,7829,8010,,181,120.16,1124713.2781954887,3586324.4
3006,11,1500000,7829,7893,,64,120.16,1820371.57,3586324.4
3007,15,550000,7830,7992,,162,120.16,4522577.48037889,3586324.4
3008,19,1000000,7831,7876,,45,120.16,6721340.5708154505,3586324.4
3009,6,1000000,7831,8010,,179,120.16,1124713.2781954887,3586324.4
3010,22,850000,7835,7912,,77,120.16,2904103.2512077293,3586324.4
3011,15,650000,7836,7856,,20,120.16,4522577.48037889,3586324.4
3012,5,600000,7838,7998,,160,120.16,1400922.5020242915,3586324.4
3013,22,750000,7838,7851,,13,120.16,2904103.2512077293,3586324.4
3014,15,900000,7838,7892,,54,120.16,4522577.48037889,3586324.4
3015,24,750000,7840,7866,,26,120.16,23456062.532786883,3586324.4
3016,23,700000,8719,8767,,48,65.64,5772926.70157068,1503028.14
3017,10,100000000,7843,8577,,734,120.16,8282326.220930233,3586324.4
3018,13,50000000,7845,8620,,775,120.16,7795654.71978022,3586324.4
3019,1,2124000,7846,7921,,75,120.16,3325419.7044334975,3586324.4
3020,15,600000,7846,7871,,25,120.16,4522577.48037889,3586324.4
3021,12,3000000,7848,7876,,28,120.16,7658937.101338432,3586324.4
3022,14,1000000,7850,7913,,63,120.16,5826416.914893617,3586324.4
3023,4,1500000,7850,7870,,20,120.16,4297914.794871795,3586324.4
3024,1,950000,7851,7901,,50,120.16,3325419.7044334975,3586324.4
3025,2,1200000,7851,7892,,41,120.16,2989003.2716499544,3586324.4
3026,11,5000000,7851,7914,,63,120.16,1820371.57,3586324.4
3027,1,1000000,7857,7878,,21,120.16,3325419.7044334975,3586324.4
3028,17,1000000,7859,7890,,31,120.16,1614143.0049603174,3586324.4
3029,20,862000,7859,7929,,70,120.16,7597088.421768707,3586324.4
3030,3,1200000,7861,8101,,240,120.16,9246769.549865229,3586324.4
3031,1,800000,7862,7900,,38,120.16,3325419.7044334975,3586324.4
3032,16,950000,7862,7880,,18,120.16,2465023.1840707962,3586324.4
3033,19,900000,7865,7914,,49,120.16,6721340.5708154505,3586324.4
3034,17,1000000,7865,7953,,88,120.16,1614143.0049603174,3586324.4
3035,11,2000000,7866,7984,,118,120.16,1820371.57,3586324.4
3036,15,43365757,7866,8860,,994,120.16,4522577.48037889,3586324.4
3037,22,700000,7869,8073,,204,120.16,2904103.2512077293,3586324.4
3038,3,2500000,7870,8593,,723,120.16,9246769.549865229,3586324.4
3039,16,1000000,7870,7886,,16,120.16,2465023.1840707962,3586324.4
3040,11,900000,7871,7893,,22,120.16,1820371.57,3586324.4
3041,11,900000,7871,7885,,14,120.16,1820371.57,3586324.4
3042,11,600000,7873,7925,,52,120.16,1820371.57,3586324.4
3043,11,600000,7873,7926,,53,120.16,1820371.57,3586324.4
3044,5,1200000,7875,7936,,61,120.16,1400922.5020242915,3586324.4
3045,13,2000000,7876,7900,,24,120.16,7795654.71978022,3586324.4
3046,3,700000,7876,8093,,217,120.16,9246769.549865229,3586324.4
3047,5,2600000,7877,7922,,45,120.16,1400922.5020242915,3586324.4
3048,11,1000000,7877,7898,,21,120.16,1820371.57,3586324.4
3049,4,1000000,7878,8219,,341,120.16,4297914.794871795,3586324.4
3050,11,999999,7878,8208,,330,120.16,1820371.57,3586324.4
3051,10,1000000,7878,8837,,959,120.16,8282326.220930233,3586324.4
3052,15,750000,7878,8138,,260,120.16,4522577.48037889,3586324.4
3053,6,560000,7878,8034,,156,120.16,1124713.2781954887,3586324.4
3054,14,850000,7878,7955,,77,120.16,5826416.914893617,3586324.4
3055,15,1100000,7880,7898,,18,120.16,4522577.48037889,3586324.4
3056,19,1000000,7880,8012,,132,120.16,6721340.5708154505,3586324.4
3057,18,1205000,7880,8164,,284,120.16,8584355.493548388,3586324.4
3058,11,900000,7882,7912,,30,120.16,1820371.57,3586324.4
3059,10,40000000,7883,8839,,956,120.16,8282326.220930233,3586324.4
3060,16,700000,7884,7921,,37,120.16,2465023.1840707962,3586324.4
3061,15,1100000,7885,7941,,56,120.16,4522577.48037889,3586324.4
3062,18,1200500,7886,8221,,335,120.16,8584355.493548388,3586324.4
3063,15,1100000,7886,7996,,110,120.16,4522577.48037889,3586324.4
3064,16,100000000,7887,8872,,985,120.16,2465023.1840707962,3586324.4
3065,13,1000000,7887,7970,,83,120.16,7795654.71978022,3586324.4
3066,15,600000,7889,7921,,32,120.16,4522577.48037889,3586324.4
3067,18,600000,7890,7960,,70,120.16,8584355.493548388,3586324.4
3068,2,700000,7891,8213,,322,120.16,2989003.2716499544,3586324.4
3069,1,800000,7891,7971,,80,120.16,3325419.7044334975,3586324.4
3070,1,1000000,7892,7926,,34,120.16,3325419.7044334975,3586324.4
3071,3,1500000,7892,8019,,127,120.16,9246769.549865229,3586324.4
3072,22,700000,7893,7907,,14,120.16,2904103.2512077293,3586324.4
3073,2,1000000,7893,7919,,26,120.16,2989003.2716499544,3586324.4
3074,1,1000000,7893,7925,,32,120.16,3325419.7044334975,3586324.4
3075,5,1200000,7894,7969,,75,120.16,1400922.5020242915,3586324.4
3076,3,75000000,7894,8682,,788,120.16,9246769.549865229,3586324.4
3077,5,600000,7894,7982,,88,120.16,1400922.5020242915,3586324.4
3078,21,1250000,7896,7977,,81,120.16,17091199.984,3586324.4
3079,18,900000,7897,7997,,100,120.16,8584355.493548388,3586324.4
3080,7,6000000,7897,8922,,1025,120.16,3738553.685483871,3586324.4
3081,17,900000,7897,7918,,21,120.16,1614143.0049603174,3586324.4
3082,18,751600,7897,7946,,49,120.16,8584355.493548388,3586324.4
3083,9,600000,7898,8199,,301,120.16,3707403.8834951455,3586324.4
3084,1,1100000,7898,7963,,65,120.16,3325419.7044334975,3586324.4
3085,2,900000,7898,8765,,867,120.16,2989003.2716499544,3586324.4
3086,2,900000,7898,8809,,911,120.16,2989003.2716499544,3586324.4
3087,11,1000000,7898,7977,,79,120.16,1820371.57,3586324.4
3088,21,1250000,7898,8093,,195,120.16,17091199.984,3586324.4
3089,21,1250000,7898,8032,,134,120.16,17091199.984,3586324.4
3090,14,15000000,7899,8858,,959,120.16,5826416.914893617,3586324.4
3091,18,1500000,7899,7934,,35,120.16,8584355.493548388,3586324.4
3092,15,680000,7901,7955,,54,120.16,4522577.48037889,3586324.4
3093,4,1000000,7901,8052,,151,120.16,4297914.794871795,3586324.4
3094,12,1000000,7903,7969,,66,120.16,7658937.101338432,3586324.4
3095,18,1000000,7903,8006,,103,120.16,8584355.493548388,3586324.4
3096,11,4800000,7903,7920,,17,120.16,1820371.57,3586324.4
3097,11,980000,7905,7935,,30,120.16,1820371.57,3586324.4
3098,11,2500000,7906,7992,,86,120.16,1820371.57,3586324.4
3099,17,900000,7907,7990,,83,120.16,1614143.0049603174,3586324.4
3100,5,550000,7907,7964,,57,120.16,1400922.5020242915,3586324.4
3101,3,750000,7908,7936,,28,120.16,9246769.549865229,3586324.4
3102,16,2104000,7909,8104,,195,120.16,2465023.1840707962,3586324.4
3103,17,900000,7909,7927,,18,120.16,1614143.0049603174,3586324.4
3104,2,2000000,7909,7961,,52,120.16,2989003.2716499544,3586324.4
3105,16,900000,7909,7939,,30,120.16,2465023.1840707962,3586324.4
3106,11,1600000,7910,8033,,123,120.16,1820371.57,3586324.4
3107,11,2500000,7911,8038,,127,120.16,1820371.57,3586324.4
3108,17,1200000,7912,7983,,71,120.16,1614143.0049603174,3586324.4
3109,2,800000,7914,7939,,25,120.16,2989003.2716499544,3586324.4
3110,2,900000,7914,7932,,18,120.16,2989003.2716499544,3586324.4
3111,22,999999,7914,7957,,43,120.16,2904103.2512077293,3586324.4
3112,16,2000000,7916,7957,,41,120.16,2465023.1840707962,3586324.4
3113,23,1200000,7916,8054,,138,120.16,5772926.70157068,3586324.4
3114,15,1335200,7917,8046,,129,120.16,4522577.48037889,3586324.4
3115,11,700000,7917,8004,,87,120.16,1820371.57,3586324.4
3116,10,1000000,7918,7995,,77,120.16,8282326.220930233,3586324.4
3117,15,700000,7919,8020,,101,120.16,4522577.48037889,3586324.4
3118,11,800000,7919,7957,,38,120.16,1820371.57,3586324.4
3119,4,750000,7920,8058,,138,120.16,4297914.794871795,3586324.4
3120,15,600000,7920,7933,,13,120.16,4522577.48037889,3586324.4
3121,1,800000,7921,8159,,238,120.16,3325419.7044334975,3586324.4
3122,3,700000,7921,8240,,319,120.16,9246769.549865229,3586324.4
3123,5,550000,7925,8024,,99,120.16,1400922.5020242915,3586324.4
3124,20,1300000,7926,7967,,41,120.16,7597088.421768707,3586324.4
3125,12,1000000,7926,7968,,42,120.16,7658937.101338432,3586324.4
3126,4,1100000,7927,7967,,40,120.16,4297914.794871795,3586324.4
3127,4,2000000,7928,8010,,82,120.16,4297914.794871795,3586324.4
3128,9,1000000,7929,7995,,66,120.16,3707403.8834951455,3586324.4
3129,18,3000000,7929,8030,,101,120.16,8584355.493548388,3586324.4
3130,0,1100000,7929,7976,,47,120.16,8418173.322222222,3586324.4
3131,13,700000,7929,7961,,32,120.16,7795654.71978022,3586324.4
3132,12,650000,7931,7947,,16,120.16,7658937.101338432,3586324.4
3133,17,800000,7931,7971,,40,120.16,1614143.0049603174,3586324.4
3134,3,50000000,7931,8893,,962,120.16,9246769.549865229,3586324.4
3135,9,1583000,7932,8019,,87,120.16,3707403.8834951455,3586324.4
3136,8,1273000,7932,7981,,49,120.16,1501617.2191780822,3586324.4
3137,17,900000,7933,8369,,436,120.16,1614143.0049603174,3586324.4
3138,14,1000000,7934,7996,,62,120.16,5826416.914893617,3586324.4
3139,2,850000,7934,8004,,70,120.16,2989003.2716499544,3586324.4
3140,16,850000,7935,7976,,41,120.16,2465023.1840707962,3586324.4
3141,15,600000,7935,7970,,35,120.16,4522577.48037889,3586324.4
3142,19,850000,7935,8017,,82,120.16,6721340.5708154505,3586324.4
3143,19,800000,7935,7962,,27,120.16,6721340.5708154505,3586324.4
3144,17,600000,7935,7970,,35,120.16,1614143.0049603174,3586324.4
3145,19,650000,7935,7984,,49,120.16,6721340.5708154505,3586324.4
3146,17,750000,7936,8097,,161,120.16,1614143.0049603174,3586324.4
3147,17,750000,7936,8101,,165,120.16,1614143.0049603174,3586324.4
3148,3,1000000,7937,7970,,33,120.16,9246769.549865229,3586324.4
3149,9,70000000,7938,8621,,683,120.16,3707403.8834951455,3586324.4
3150,3,1000000,7939,7995,,56,120.16,9246769.549865229,3586324.4
3151,18,1000000,7940,7961,,21,120.16,8584355.493548388,3586324.4
3152,2,1050000,7940,8005,,65,120.16,2989003.2716499544,3586324.4
3153,11,700000,7940,8018,,78,120.16,1820371.57,3586324.4
3154,2,800000,7941,8046,,105,120.16,2989003.2716499544,3586324.4
3155,9,850000,7941,8011,,70,120.16,3707403.8834951455,3586324.4
3156,16,2500000,7941,7983,,42,120.16,2465023.1840707962,3586324.4
3157,15,750000,7943,8058,,115,120.16,4522577.48037889,3586324.4
3158,18,700000,7944,8010,,66,120.16,8584355.493548388,3586324.4
3159,21,100000000,7946,8425,,479,120.16,17091199.984,3586324.4
3160,15,600000,7947,8048,,101,120.16,4522577.48037889,3586324.4
3161,15,600000,7948,7970,,22,120.16,4522577.48037889,3586324.4
3162,16,1000000,7949,7978,,29,120.16,2465023.1840707962,3586324.4
3163,2,1000000,7949,8004,,55,120.16,2989003.2716499544,3586324.4
3164,16,1500000,7950,8081,,131,120.16,2465023.1840707962,3586324.4
3165,24,600000,7951,8026,,75,120.16,23456062.532786883,3586324.4
3166,23,800000,7954,8621,,667,120.16,5772926.70157068,3586324.4
3167,12,700000,7954,8025,,71,120.16,7658937.101338432,3586324.4
3168,11,1200000,7956,7997,,41,120.16,1820371.57,3586324.4
3169,17,780000,7956,8012,,56,120.16,1614143.0049603174,3586324.4
3170,12,750000,7956,8179,,223,120.16,7658937.101338432,3586324.4
3171,15,1000000,7957,7983,,26,120.16,4522577.48037889,3586324.4
3172,19,1000000,7957,7977,,20,120.16,6721340.5708154505,3586324.4
3173,2,800000,7957,7990,,33,120.16,2989003.2716499544,3586324.4
3174,12,750000,7957,8380,,423,120.16,7658937.101338432,3586324.4
3175,15,800000,7958,7992,,34,120.16,4522577.48037889,3586324.4
3176,17,1000000,7958,8011,,53,120.16,1614143.0049603174,3586324.4
3177,3,13000000,7960,7992,,32,120.16,9246769.549865229,3586324.4
3178,3,800000,7961,8019,,58,120.16,9246769.549865229,3586324.4
3179,17,1500000,7963,8003,,40,120.16,1614143.0049603174,3586324.4
3180,16,800000,7963,8013,,50,120.16,2465023.1840707962,3586324.4
3181,11,2000000,7963,7996,,33,120.16,1820371.57,3586324.4
3182,8,960000,7963,7996,,33,120.16,1501617.2191780822,3586324.4
3183,2,700000,7964,7982,,18,120.16,2989003.2716499544,3586324.4
3184,2,700000,7964,8005,,41,120.16,2989003.2716499544,3586324.4
3185,5,1200000,7964,8145,,181,120.16,1400922.5020242915,3586324.4
3186,16,900000,7964,8097,,133,120.16,2465023.1840707962,3586324.4
3187,16,900000,7964,8129,,165,120.16,2465023.1840707962,3586324.4
3188,9,650000,7965,8005,,40,120.16,3707403.8834951455,3586324.4
3189,17,1000000,7966,7983,,17,120.16,1614143.0049603174,3586324.4
3190,19,800000,7967,8046,,79,120.16,6721340.5708154505,3586324.4
3191,17,700000,7968,8011,,43,120.16,1614143.0049603174,3586324.4
3192,11,1000000,7968,8016,,48,120.16,1820371.57,3586324.4
3193,15,550000,7968,8018,,50,120.16,4522577.48037889,3586324.4
3194,0,850000,7969,7985,,16,120.16,8418173.322222222,3586324.4
3195,2,850000,7969,8094,,125,120.16,2989003.2716499544,3586324.4
3196,11,1000000,7969,8046,,77,120.16,1820371.57,3586324.4
3197,11,1000000,7969,8062,,93,120.16,1820371.57,3586324.4
3198,15,800000,7970,7999,,29,120.16,4522577.48037889,3586324.4
3199,22,750000,7971,8048,,77,120.16,2904103.2512077293,3586324.4
3200,12,1000000,7971,8006,,35,120.16,7658937.101338432,3586324.4
3201,2,800000,7973,7998,,25,120.16,2989003.2716499544,3586324.4
3202,15,1200000,7976,8032,,56,120.16,4522577.48037889,3586324.4
3203,21,3000000,7976,8212,,236,120.16,17091199.984,3586324.4
3204,3,1100000,7978,8018,,40,120.16,9246769.549865229,3586324.4
3205,17,1250000,7980,7999,,19,120.16,1614143.0049603174,3586324.4
3206,15,1000000,7981,8061,,80,120.16,4522577.48037889,3586324.4
3207,12,1000000,7982,8006,,24,120.16,7658937.101338432,3586324.4
3208,11,700000,7983,7999,,16,120.16,1820371.57,3586324.4
3209,11,1000000,7983,8171,,188,120.16,1820371.57,3586324.4
3210,0,620000,7983,8296,,313,120.16,8418173.322222222,3586324.4
3211,0,650000,7983,8296,,313,120.16,8418173.322222222,3586324.4
3212,0,650000,7983,8296,,313,120.16,8418173.322222222,3586324.4
3213,0,700000,7983,8284,,301,120.16,8418173.322222222,3586324.4
3214,12,1500000,7984,8012,,28,120.16,7658937.101338432,3586324.4
3215,15,950000,7984,8235,,251,120.16,4522577.48037889,3586324.4
3216,17,700000,7984,8003,,19,120.16,1614143.0049603174,3586324.4
3217,11,59000000,7984,8676,,692,120.16,1820371.57,3586324.4
3218,4,800000,7988,8037,,49,120.16,4297914.794871795,3586324.4
3219,1,1000000,7988,8052,,64,120.16,3325419.7044334975,3586324.4
3220,15,900000,7989,8027,,38,120.16,4522577.48037889,3586324.4
3221,17,1000000,7989,8010,,21,120.16,1614143.0049603174,3586324.4
3222,2,844000,7989,8061,,72,120.16,2989003.2716499544,3586324.4
3223,2,1250000,7990,8053,,63,120.16,2989003.2716499544,3586324.4
3224,16,650000,7990,8039,,49,120.16,2465023.1840707962,3586324.4
3225,2,900000,7990,8030,,40,120.16,2989003.2716499544,3586324.4
3226,12,1700000,7991,8034,,43,120.16,7658937.101338432,3586324.4
3227,18,1200000,7991,8013,,22,120.16,8584355.493548388,3586324.4
3228,13,3000000,7991,8027,,36,120.16,7795654.71978022,3586324.4
3229,17,50000000,7991,8513,,522,120.16,1614143.0049603174,3586324.4
3230,11,800000,7991,8023,,32,120.16,1820371.57,3586324.4
3231,19,1000000,7992,8060,,68,120.16,6721340.5708154505,3586324.4
3232,17,750000,7992,8038,,46,120.16,1614143.0049603174,3586324.4
3233,2,1000000,7993,8027,,34,120.16,2989003.2716499544,3586324.4
3234,22,750000,7995,8117,,122,120.16,2904103.2512077293,3586324.4
3235,5,650000,7995,8086,,91,120.16,1400922.5020242915,3586324.4
3236,17,1500000,7996,8051,,55,120.16,1614143.0049603174,3586324.4
3237,2,1000000,7997,8062,,65,120.16,2989003.2716499544,3586324.4
3238,15,650000,7997,8249,,252,120.16,4522577.48037889,3586324.4
3239,15,815000,7998,8016,,18,120.16,4522577.48037889,3586324.4
3240,2,1000000,7998,8032,,34,120.16,2989003.2716499544,3586324.4
3241,16,900000,7998,8065,,67,120.16,2465023.1840707962,3586324.4
3242,12,600000,7998,8086,,88,120.16,7658937.101338432,3586324.4
3243,16,510000,7998,8129,,131,120.16,2465023.1840707962,3586324.4
3244,16,900000,7999,8114,,115,120.16,2465023.1840707962,3586324.4
3245,6,600000,8000,8207,,207,120.16,1124713.2781954887,3586324.4
3246,11,1700000,8001,8020,,19,120.16,1820371.57,3586324.4
3247,11,900000,8003,8115,,112,120.16,1820371.57,3586324.4
3248,1,900000,8003,8247,,244,120.16,3325419.7044334975,3586324.4
3249,23,750000,8003,8045,,42,120.16,5772926.70157068,3586324.4
3250,15,600000,8004,8045,,41,120.16,4522577.48037889,3586324.4
3251,22,950000,8005,8053,,48,120.16,2904103.2512077293,3586324.4
3252,11,1250000,8005,8080,,75,120.16,1820371.57,3586324.4
3253,18,1800000,8005,8466,,461,120.16,8584355.493548388,3586324.4
3254,6,1200000,8006,8097,,91,120.16,1124713.2781954887,3586324.4
3255,22,1000000,8006,8146,,140,120.16,2904103.2512077293,3586324.4
3256,13,1500000,8006,8046,,40,120.16,7795654.71978022,3586324.4
3257,17,1000000,8007,8030,,23,120.16,1614143.0049603174,3586324.4
3258,18,800000,8008,8053,,45,120.16,8584355.493548388,3586324.4
3259,2,1000000,8010,8088,,78,120.16,2989003.2716499544,3586324.4
3260,12,1000000,8010,8188,,178,120.16,7658937.101338432,3586324.4
3261,17,900000,8011,8139,,128,120.16,1614143.0049603174,3586324.4
3262,16,650000,8012,8045,,33,120.16,2465023.1840707962,3586324.4
3263,11,1150000,8012,8158,,146,120.16,1820371.57,3586324.4
3264,15,1000000,8013,8037,,24,120.16,4522577.48037889,3586324.4
3265,12,1000000,8016,8037,,21,120.16,7658937.101338432,3586324.4
3266,15,700000,8017,8052,,35,120.16,4522577.48037889,3586324.4
3267,3,1500000,8018,8047,,29,120.16,9246769.549865229,3586324.4
3268,22,1000000,8018,8202,,184,120.16,2904103.2512077293,3586324.4
3269,6,1000000,8019,8051,,32,120.16,1124713.2781954887,3586324.4
3270,22,1000000,8019,8045,,26,120.16,2904103.2512077293,3586324.4
3271,11,1193375,8019,8184,,165,120.16,1820371.57,3586324.4
3272,16,1000000,8020,8090,,70,120.16,2465023.1840707962,3586324.4
3273,13,1150000,8023,8174,,151,120.16,7795654.71978022,3586324.4
3274,2,850000,8023,8072,,49,120.16,2989003.2716499544,3586324.4
3275,11,900000,8024,8081,,57,120.16,1820371.57,3586324.4
3276,16,2025464,8024,8093,,69,120.16,2465023.1840707962,3586324.4
3277,2,900000,8024,8039,,15,120.16,2989003.2716499544,3586324.4
3278,11,1600000,8025,8058,,33,120.16,1820371.57,3586324.4
3279,2,2500000,8025,8326,,301,120.16,2989003.2716499544,3586324.4
3280,4,1200000,8029,8037,,8,120.16,4297914.794871795,3586324.4
3281,16,1650000,8029,8093,,64,120.16,2465023.1840707962,3586324.4
3282,1,1500000,8029,8048,,19,120.16,3325419.7044334975,3586324.4
3283,15,600000,8030,8051,,21,120.16,4522577.48037889,3586324.4
3284,20,750000,8031,8100,,69,120.16,7597088.421768707,3586324.4
3285,4,1198375,8031,8264,,233,120.16,4297914.794871795,3586324.4
3286,18,900000,8033,8086,,53,120.16,8584355.493548388,3586324.4
3287,17,1500000,8034,8335,,301,120.16,1614143.0049603174,3586324.4
3288,5,1000000,8035,8137,,102,120.16,1400922.5020242915,3586324.4
3289,23,1500000,8035,8103,,68,120.16,5772926.70157068,3586324.4
3290,5,9000000,8037,8731,,694,120.16,1400922.5020242915,3586324.4
3291,11,5000000,8037,8081,,44,120.16,1820371.57,3586324.4
3292,15,20000000,8038,8802,,764,120.16,4522577.48037889,3586324.4
3293,15,20000000,8038,8802,,764,120.16,4522577.48037889,3586324.4
3294,15,20000000,8038,8802,,764,120.16,4522577.48037889,3586324.4
3295,15,20000000,8039,8802,,763,120.16,4522577.48037889,3586324.4
3296,15,20000000,8039,8802,,763,120.16,4522577.48037889,3586324.4
3297,6,1000000,8039,8090,,51,120.16,1124713.2781954887,3586324.4
3298,2,850000,8039,8074,,35,120.16,2989003.2716499544,3586324.4
3299,11,1650000,8039,8094,,55,120.16,1820371.57,3586324.4
3300,16,9353893,8041,8263,,222,120.16,2465023.1840707962,3586324.4
3301,12,2000000,8042,8067,,25,120.16,7658937.101338432,3586324.4
3302,11,1000000,8046,8073,,27,120.16,1820371.57,3586324.4
3303,1,900000,8046,8073,,27,120.16,3325419.7044334975,3586324.4
3304,3,78000000,8046,8800,,754,120.16,9246769.549865229,3586324.4
3305,2,900000,8047,8130,,83,120.16,2989003.2716499544,3586324.4
3306,1,900000,8047,8081,,34,120.16,3325419.7044334975,3586324.4
3307,3,520000,8047,8079,,32,120.16,9246769.549865229,3586324.4
3308,12,1000000,8047,8086,,39,120.16,7658937.101338432,3586324.4
3309,12,1000000,8048,8174,,126,120.16,7658937.101338432,3586324.4
3310,12,1000000,8049,8117,,68,120.16,7658937.101338432,3586324.4
3311,15,1500000,8049,8104,,55,120.16,4522577.48037889,3586324.4
3312,18,73300000,8053,8895,,842,120.16,8584355.493548388,3586324.4
3313,4,1500000,8054,8069,,15,120.16,4297914.794871795,3586324.4
3314,5,850000,8058,8086,,28,120.16,1400922.5020242915,3586324.4
3315,18,800000,8058,8082,,24,120.16,8584355.493548388,3586324.4
3316,12,1000000,8059,8102,,43,120.16,7658937.101338432,3586324.4
3317,13,700000,8060,8283,,223,120.16,7795654.71978022,3586324.4
3318,13,700000,8060,8278,,218,120.16,7795654.71978022,3586324.4
3319,16,9353893,8061,8263,,202,120.16,2465023.1840707962,3586324.4
3320,1,1000000,8061,8089,,28,120.16,3325419.7044334975,3586324.4
3321,16,9353893,8061,8264,,203,120.16,2465023.1840707962,3586324.4
3322,23,900000,8061,8114,,53,120.16,5772926.70157068,3586324.4
3323,19,560000,8062,8096,,34,120.16,6721340.5708154505,3586324.4
3324,5,800000,8064,8094,,30,120.16,1400922.5020242915,3586324.4
3325,19,560000,8065,8096,,31,120.16,6721340.5708154505,3586324.4
3326,9,700000,8065,8083,,18,120.16,3707403.8834951455,3586324.4
3327,16,600000,8066,8135,,69,120.16,2465023.1840707962,3586324.4
3328,3,750000,8066,8111,,45,120.16,9246769.549865229,3586324.4
3329,16,800000,8066,8207,,141,120.16,2465023.1840707962,3586324.4
3330,3,1000000,8070,8087,,17,120.16,9246769.549865229,3586324.4
3331,6,35000000,8072,8873,,801,120.16,1124713.2781954887,3586324.4
3332,17,700000,8072,8243,,171,120.16,1614143.0049603174,3586324.4
3333,4,800000,8073,8179,,106,120.16,4297914.794871795,3586324.4
3334,12,1000000,8073,8136,,63,120.16,7658937.101338432,3586324.4
3335,8,600000,8073,8389,,316,120.16,1501617.2191780822,3586324.4
3336,17,1000000,8074,8100,,26,120.16,1614143.0049603174,3586324.4
3337,11,20000000,8074,8275,,201,120.16,1820371.57,3586324.4
3338,2,600000,8074,8144,,70,120.16,2989003.2716499544,3586324.4
3339,5,750000,8076,8222,,146,120.16,1400922.5020242915,3586324.4
3340,17,700000,8078,8132,,54,120.16,1614143.0049603174,3586324.4
3341,16,900000,8079,8107,,28,120.16,2465023.1840707962,3586324.4
3342,16,1280000,8079,8135,,56,120.16,2465023.1840707962,3586324.4
3343,15,950000,8080,8116,,36,120.16,4522577.48037889,3586324.4
3344,2,800000,8081,8179,,98,120.16,2989003.2716499544,3586324.4
3345,11,3000000,8081,8181,,100,120.16,1820371.57,3586324.4
3346,15,720000,8081,8129,,48,120.16,4522577.48037889,3586324.4
3347,1,100000000,8082,8552,,470,120.16,3325419.7044334975,3586324.4
3348,12,763792,8084,8160,,76,120.16,7658937.101338432,3586324.4
3349,18,1361600,8087,8108,,21,120.16,8584355.493548388,3586324.4
3350,17,3272664,8087,8489,,402,120.16,1614143.0049603174,3586324.4
3351,17,3204360,8087,8584,,497,120.16,1614143.0049603174,3586324.4
3352,16,900000,8088,8137,,49,120.16,2465023.1840707962,3586324.4
3353,16,1828000,8088,8115,,27,120.16,2465023.1840707962,3586324.4
3354,2,1000000,8089,8202,,113,120.16,2989003.2716499544,3586324.4
3355,14,550000,8089,8507,,418,120.16,5826416.914893617,3586324.4
3356,15,750000,8089,8186,,97,120.16,4522577.48037889,3586324.4
3357,0,850000,8089,8209,,120,120.16,8418173.322222222,3586324.4
3358,2,1000000,8090,8391,,301,120.16,2989003.2716499544,3586324.4
3359,22,700000,8090,8158,,68,120.16,2904103.2512077293,3586324.4
3360,12,1000000,8093,8156,,63,120.16,7658937.101338432,3586324.4
3361,17,1200000,8093,8136,,43,120.16,1614143.0049603174,3586324.4
3362,6,1000000,8093,8170,,77,120.16,1124713.2781954887,3586324.4
3363,6,1000000,8093,8170,,77,120.16,1124713.2781954887,3586324.4
3364,15,800000,8093,8185,,92,120.16,4522577.48037889,3586324.4
3365,2,1000000,8093,8143,,50,120.16,2989003.2716499544,3586324.4
3366,18,821596,8094,8159,,65,120.16,8584355.493548388,3586324.4
3367,5,700000,8095,8110,,15,120.16,1400922.5020242915,3586324.4
3368,11,1500000,8095,8208,,113,120.16,1820371.57,3586324.4
3369,2,1000000,8096,8135,,39,120.16,2989003.2716499544,3586324.4
3370,1,30000000,8096,8516,,420,120.16,3325419.7044334975,3586324.4
3371,2,900000,8096,8149,,53,120.16,2989003.2716499544,3586324.4
3372,2,1000000,8096,8205,,109,120.16,2989003.2716499544,3586324.4
3373,16,1350000,8098,8186,,88,120.16,2465023.1840707962,3586324.4
3374,2,1000000,8100,8202,,102,120.16,2989003.2716499544,3586324.4
3375,5,795000,8100,8111,,11,120.16,1400922.5020242915,3586324.4
3376,16,1850000,8101,8191,,90,120.16,2465023.1840707962,3586324.4
3377,21,100000000,8101,8684,,583,120.16,17091199.984,3586324.4
3378,18,750000,8102,8115,,13,120.16,8584355.493548388,3586324.4
3379,3,44000000,8102,8703,,601,120.16,9246769.549865229,3586324.4
3380,19,900000,8106,8149,,43,120.16,6721340.5708154505,3586324.4
3381,4,1000000,8106,8192,,86,120.16,4297914.794871795,3586324.4
3382,5,900000,8107,8192,,85,120.16,1400922.5020242915,3586324.4
3383,16,1500000,8107,8138,,31,120.16,2465023.1840707962,3586324.4
3384,15,800000,8108,8247,,139,120.16,4522577.48037889,3586324.4
3385,4,1000000,8108,8192,,84,120.16,4297914.794871795,3586324.4
3386,15,525000,8108,8179,,71,120.16,4522577.48037889,3586324.4
3387,15,525000,8109,8641,,532,120.16,4522577.48037889,3586324.4
3388,11,1368500,8109,8236,,127,120.16,1820371.57,3586324.4
3389,15,1250000,8109,8142,,33,120.16,4522577.48037889,3586324.4
3390,21,2000000,8109,8137,,28,120.16,17091199.984,3586324.4
3391,21,140000000,8109,8906,,797,120.16,17091199.984,3586324.4
3392,20,800000,8111,8531,,420,120.16,7597088.421768707,3586324.4
3393,20,800000,8111,8530,,419,120.16,7597088.421768707,3586324.4
3394,17,1350000,8112,8139,,27,120.16,1614143.0049603174,3586324.4
3395,2,700000,8114,8201,,87,120.16,2989003.2716499544,3586324.4
3396,13,2006150,8115,8173,,58,120.16,7795654.71978022,3586324.4
3397,24,1200000,8115,8219,,104,120.16,23456062.532786883,3586324.4
3398,11,1350000,8116,8254,,138,120.16,1820371.57,3586324.4
3399,12,1000000,8116,8158,,42,120.16,7658937.101338432,3586324.4
3400,0,31097500,8118,8839,,721,120.16,8418173.322222222,3586324.4
3401,12,1000000,8122,8167,,45,120.16,7658937.101338432,3586324.4
3402,3,6000000,8122,8174,,52,120.16,9246769.549865229,3586324.4
3403,9,880000,8124,8171,,47,120.16,3707403.8834951455,3586324.4
3404,17,3204360,8124,8584,,460,120.16,1614143.0049603174,3586324.4
3405,20,600000,8125,8376,,251,120.16,7597088.421768707,3586324.4
3406,21,4844579,8127,8216,,89,99.44,17091199.984,1975331.43
3407,15,1736400,8128,8149,,21,99.44,4522577.48037889,1975331.43
3408,4,900000,8128,8598,,470,99.44,4297914.794871795,1975331.43
3409,19,900000,8129,8166,,37,99.44,6721340.5708154505,1975331.43
3410,15,1000000,8129,8209,,80,99.44,4522577.48037889,1975331.43
3411,9,1000000,8129,8153,,24,99.44,3707403.8834951455,1975331.43
3412,15,1000000,8129,8167,,38,99.44,4522577.48037889,1975331.43
3413,9,1000000,8129,8158,,29,99.44,3707403.8834951455,1975331.43
3414,2,850000,8130,8186,,56,99.44,2989003.2716499544,1975331.43
3415,12,1000000,8130,8174,,44,99.44,7658937.101338432,1975331.43
3416,5,700000,8130,8243,,113,99.44,1400922.5020242915,1975331.43
3417,16,1550000,8130,8151,,21,99.44,2465023.1840707962,1975331.43
3418,16,700000,8131,8172,,41,99.44,2465023.1840707962,1975331.43
3419,17,1000000,8131,8171,,40,99.44,1614143.0049603174,1975331.43
3420,23,650000,8131,8276,,145,99.44,5772926.70157068,1975331.43
3421,3,2400000,8131,8187,,56,99.44,9246769.549865229,1975331.43
3422,11,600000,8131,8215,,84,99.44,1820371.57,1975331.43
3423,5,600000,8132,8473,,341,99.44,1400922.5020242915,1975331.43
3424,6,830920,8132,8387,,255,99.44,1124713.2781954887,1975331.43
3425,15,1000000,8135,8200,,65,99.44,4522577.48037889,1975331.43
3426,24,1000000,8135,8207,,72,99.44,23456062.532786883,1975331.43
3427,11,700000,8138,8164,,26,99.44,1820371.57,1975331.43
3428,14,840000,8138,8178,,40,99.44,5826416.914893617,1975331.43
3429,23,1200000,8138,8192,,54,99.44,5772926.70157068,1975331.43
3430,1,750000,8139,8202,,63,99.44,3325419.7044334975,1975331.43
3431,17,1500000,8139,8170,,31,99.44,1614143.0049603174,1975331.43
3432,9,3500000,8139,8213,,74,99.44,3707403.8834951455,1975331.43
3433,11,950000,8140,8205,,65,99.44,1820371.57,1975331.43
3434,17,1000000,8140,8412,,272,99.44,1614143.0049603174,1975331.43
3435,6,600000,8141,8570,,429,99.44,1124713.2781954887,1975331.43
3436,5,1384000,8143,8185,,42,99.44,1400922.5020242915,1975331.43
3437,15,600000,8143,8212,,69,99.44,4522577.48037889,1975331.43
3438,1,800000,8143,8303,,160,99.44,3325419.7044334975,1975331.43
3439,5,600000,8143,8780,,637,99.44,1400922.5020242915,1975331.43
3440,9,900000,8144,8237,,93,99.44,3707403.8834951455,1975331.43
3441,24,580000,8144,8185,,41,99.44,23456062.532786883,1975331.43
3442,1,875000,8145,8261,,116,99.44,3325419.7044334975,1975331.43
3443,11,1500000,8145,8193,,48,99.44,1820371.57,1975331.43
3444,17,700000,8145,8298,,153,99.44,1614143.0049603174,1975331.43
3445,12,1700000,8146,8416,,270,99.44,7658937.101338432,1975331.43
3446,19,975000,8146,8215,,69,99.44,6721340.5708154505,1975331.43
3447,17,1500000,8148,8205,,57,99.44,1614143.0049603174,1975331.43
3448,11,800000,8148,8235,,87,99.44,1820371.57,1975331.43
3449,17,800000,8149,8375,,226,99.44,1614143.0049603174,1975331.43
3450,8,600000,8150,8368,,218,99.44,1501617.2191780822,1975331.43
3451,1,700000,8150,8205,,55,99.44,3325419.7044334975,1975331.43
3452,22,1300000,8151,8250,,99,99.44,2904103.2512077293,1975331.43
3453,12,975000,8151,8342,,191,99.44,7658937.101338432,1975331.43
3454,11,1000000,8151,8205,,54,99.44,1820371.57,1975331.43
3455,5,1000000,8157,8286,,129,99.44,1400922.5020242915,1975331.43
3456,24,10000000,8157,8444,,287,99.44,23456062.532786883,1975331.43
3457,15,750000,8157,8209,,52,99.44,4522577.48037889,1975331.43
3458,12,1500000,8158,8191,,33,99.44,7658937.101338432,1975331.43
3459,3,2000000,8158,8199,,41,99.44,9246769.549865229,1975331.43
3460,11,1000000,8159,8193,,34,99.44,1820371.57,1975331.43
3461,15,600000,8159,8202,,43,99.44,4522577.48037889,1975331.43
3462,9,750000,8159,8283,,124,99.44,3707403.8834951455,1975331.43
3463,17,1350000,8160,8216,,56,99.44,1614143.0049603174,1975331.43
3464,14,800000,8160,8250,,90,99.44,5826416.914893617,1975331.43
3465,5,600000,8163,8415,,252,99.44,1400922.5020242915,1975331.43
3466,11,1354046,8163,8298,,135,99.44,1820371.57,1975331.43
3467,12,1000000,8163,8179,,16,99.44,7658937.101338432,1975331.43
3468,2,950000,8163,8214,,51,99.44,2989003.2716499544,1975331.43
3469,17,1000000,8164,8263,,99,99.44,1614143.0049603174,1975331.43
3470,8,970000,8164,8223,,59,99.44,1501617.2191780822,1975331.43
3471,11,1100000,8164,8284,,120,99.44,1820371.57,1975331.43
3472,16,950000,8164,8222,,58,99.44,2465023.1840707962,1975331.43
3473,11,5000000,8164,8240,,76,99.44,1820371.57,1975331.43
3474,23,900000,8165,8236,,71,99.44,5772926.70157068,1975331.43
3475,15,800000,8165,8219,,54,99.44,4522577.48037889,1975331.43
3476,16,1000000,8166,8229,,63,99.44,2465023.1840707962,1975331.43
3477,5,800000,8171,8192,,21,99.44,1400922.5020242915,1975331.43
3478,15,900000,8172,8220,,48,99.44,4522577.48037889,1975331.43
3479,22,750000,8172,8241,,69,99.44,2904103.2512077293,1975331.43
3480,15,700000,8173,8284,,111,99.44,4522577.48037889,1975331.43
3481,5,1000000,8173,8194,,21,99.44,1400922.5020242915,1975331.43
3482,1,800000,8173,8265,,92,99.44,3325419.7044334975,1975331.43
3483,1,950000,8173,8223,,50,99.44,3325419.7044334975,1975331.43
3484,17,1000000,8173,8320,,147,99.44,1614143.0049603174,1975331.43
3485,16,1600000,8178,8255,,77,99.44,2465023.1840707962,1975331.43
3486,19,1500000,8178,8317,,139,99.44,6721340.5708154505,1975331.43
3487,6,800000,8179,8775,,596,99.44,1124713.2781954887,1975331.43
3488,15,1200000,8179,8250,,71,99.44,4522577.48037889,1975331.43
3489,3,8000000,8179,8257,,78,99.44,9246769.549865229,1975331.43
3490,17,900000,8180,8236,,56,99.44,1614143.0049603174,1975331.43
3491,23,850000,8180,8240,,60,99.44,5772926.70157068,1975331.43
3492,16,1979600,8180,8352,,172,99.44,2465023.1840707962,1975331.43
3493,2,2000000,8180,8242,,62,99.44,2989003.2716499544,1975331.43
3494,11,750000,8181,8234,,53,99.44,1820371.57,1975331.43
3495,7,1000000,8181,8251,,70,99.44,3738553.685483871,1975331.43
3496,5,600000,8181,8508,,327,99.44,1400922.5020242915,1975331.43
3497,2,875000,8184,8213,,29,99.44,2989003.2716499544,1975331.43
3498,9,800000,8184,8248,,64,99.44,3707403.8834951455,1975331.43
3499,3,2000000,8184,8321,,137,99.44,9246769.549865229,1975331.43
3500,16,800000,8184,8221,,37,99.44,2465023.1840707962,1975331.43
3501,2,800000,8185,8402,,217,99.44,2989003.2716499544,1975331.43
3502,6,995000,8185,8206,,21,99.44,1124713.2781954887,1975331.43
3503,2,750000,8186,8279,,93,99.44,2989003.2716499544,1975331.43
3504,7,1000000,8186,8251,,65,99.44,3738553.685483871,1975331.43
3505,17,1000000,8186,8216,,30,99.44,1614143.0049603174,1975331.43
3506,16,900000,8186,8243,,57,99.44,2465023.1840707962,1975331.43
3507,22,550000,8187,8766,,579,99.44,2904103.2512077293,1975331.43
3508,11,750000,8187,8247,,60,99.44,1820371.57,1975331.43
3509,23,1000000,8187,8279,,92,99.44,5772926.70157068,1975331.43
3510,15,1100000,8188,8236,,48,99.44,4522577.48037889,1975331.43
3511,4,850000,8188,8213,,25,99.44,4297914.794871795,1975331.43
3512,5,800000,8188,8306,,118,99.44,1400922.5020242915,1975331.43
3513,22,800000,8188,8388,,200,99.44,2904103.2512077293,1975331.43
3514,6,1000000,8191,8293,,102,99.44,1124713.2781954887,1975331.43
3515,9,1200000,8191,8333,,142,99.44,3707403.8834951455,1975331.43
3516,24,18000000,8191,8279,,88,99.44,23456062.532786883,1975331.43
3517,17,2000000,8192,8215,,23,99.44,1614143.0049603174,1975331.43
3518,4,650000,8193,8240,,47,99.44,4297914.794871795,1975331.43
3519,5,750000,8193,8226,,33,99.44,1400922.5020242915,1975331.43
3520,2,1200000,8193,8251,,58,99.44,2989003.2716499544,1975331.43
3521,22,800000,8194,8523,,329,99.44,2904103.2512077293,1975331.43
3522,12,800000,8194,8212,,18,99.44,7658937.101338432,1975331.43
3523,3,20000000,8195,8382,,187,99.44,9246769.549865229,1975331.43
3524,2,750000,8195,8279,,84,99.44,2989003.2716499544,1975331.43
3525,2,950000,8195,8395,,200,99.44,2989003.2716499544,1975331.43
3526,10,900000,8198,8241,,43,99.44,8282326.220930233,1975331.43
3527,12,800000,8198,8270,,72,99.44,7658937.101338432,1975331.43
3528,5,590000,8198,8249,,51,99.44,1400922.5020242915,1975331.43
3529,16,800000,8199,8244,,45,99.44,2465023.1840707962,1975331.43
3530,23,900000,8200,8223,,23,99.44,5772926.70157068,1975331.43
3531,12,1500000,8200,8402,,202,99.44,7658937.101338432,1975331.43
3532,1,1500000,8200,8216,,16,99.44,3325419.7044334975,1975331.43
3533,17,700000,8201,8257,,56,99.44,1614143.0049603174,1975331.43
3534,16,1000000,8202,8627,,425,99.44,2465023.1840707962,1975331.43
3535,17,800000,8206,8226,,20,99.44,1614143.0049603174,1975331.43
3536,16,900000,8206,8257,,51,99.44,2465023.1840707962,1975331.43
3537,11,2000000,8206,8263,,57,99.44,1820371.57,1975331.43
3538,11,800000,8206,8271,,65,99.44,1820371.57,1975331.43
3539,17,600000,8207,8222,,15,99.44,1614143.0049603174,1975331.43
3540,22,1000000,8207,8235,,28,99.44,2904103.2512077293,1975331.43
3541,17,800000,8207,8291,,84,99.44,1614143.0049603174,1975331.43
3542,0,550000,8207,8341,,134,99.44,8418173.322222222,1975331.43
3543,22,520000,8207,8487,,280,99.44,2904103.2512077293,1975331.43
3544,17,1500000,8207,8223,,16,99.44,1614143.0049603174,1975331.43
3545,2,680000,8207,8241,,34,99.44,2989003.2716499544,1975331.43
3546,21,750000,8208,8241,,33,99.44,17091199.984,1975331.43
3547,2,800000,8209,8227,,18,99.44,2989003.2716499544,1975331.43
3548,17,700000,8209,8254,,45,99.44,1614143.0049603174,1975331.43
3549,17,700000,8209,8229,,20,99.44,1614143.0049603174,1975331.43
3550,19,1200000,8210,8305,,95,99.44,6721340.5708154505,1975331.43
3551,17,750000,8211,8534,,323,99.44,1614143.0049603174,1975331.43
3552,15,3500000,8211,8292,,81,99.44,4522577.48037889,1975331.43
3553,11,900000,8212,8417,,205,99.44,1820371.57,1975331.43
3554,2,900000,8212,8258,,46,99.44,2989003.2716499544,1975331.43
3555,10,32850000,8213,8839,,626,99.44,8282326.220930233,1975331.43
3556,9,1000000,8214,8237,,23,99.44,3707403.8834951455,1975331.43
3557,18,900000,8214,8254,,40,99.44,8584355.493548388,1975331.43
3558,5,850000,8215,8285,,70,99.44,1400922.5020242915,1975331.43
3559,17,1500000,8215,8250,,35,99.44,1614143.0049603174,1975331.43
3560,15,890000,8215,8255,,40,99.44,4522577.48037889,1975331.43
3561,18,1100000,8215,8254,,39,99.44,8584355.493548388,1975331.43
3562,9,630000,8216,8615,,399,99.44,3707403.8834951455,1975331.43
3563,1,690000,8216,8243,,27,99.44,3325419.7044334975,1975331.43
3564,11,1000000,8216,8291,,75,99.44,1820371.57,1975331.43
3565,15,1000000,8216,8577,,361,99.44,4522577.48037889,1975331.43
3566,15,1000000,8216,8577,,361,99.44,4522577.48037889,1975331.43
3567,11,1500000,8216,8261,,45,99.44,1820371.57,1975331.43
3568,17,850000,8218,8283,,65,99.44,1614143.0049603174,1975331.43
3569,17,800000,8219,8235,,16,99.44,1614143.0049603174,1975331.43
3570,12,5000000,8219,8445,,226,99.44,7658937.101338432,1975331.43
3571,23,1100000,8220,8331,,111,99.44,5772926.70157068,1975331.43
3572,5,1500000,8220,8240,,20,99.44,1400922.5020242915,1975331.43
3573,20,900000,8220,8355,,135,99.44,7597088.421768707,1975331.43
3574,16,1677200,8221,8292,,71,99.44,2465023.1840707962,1975331.43
3575,0,600000,8222,8314,,92,99.44,8418173.322222222,1975331.43
3576,5,540000,8222,8279,,57,99.44,1400922.5020242915,1975331.43
3577,5,540000,8222,8279,,57,99.44,1400922.5020242915,1975331.43
3578,1,800000,8222,8261,,39,99.44,3325419.7044334975,1975331.43
3579,8,1200000,8223,8272,,49,99.44,1501617.2191780822,1975331.43
3580,15,800000,8223,8277,,54,99.44,4522577.48037889,1975331.43
3581,12,1500000,8226,8275,,49,99.44,7658937.101338432,1975331.43
3582,12,502330,8226,8334,,108,99.44,7658937.101338432,1975331.43
3583,2,1000000,8227,8313,,86,99.44,2989003.2716499544,1975331.43
3584,19,650000,8227,8261,,34,99.44,6721340.5708154505,1975331.43
3585,15,700000,8227,8256,,29,99.44,4522577.48037889,1975331.43
3586,2,760000,8227,8325,,98,99.44,2989003.2716499544,1975331.43
3587,15,660000,8228,8446,,218,99.44,4522577.48037889,1975331.43
3588,11,1500000,8229,8272,,43,99.44,1820371.57,1975331.43
3589,3,2000000,8229,8304,,75,99.44,9246769.549865229,1975331.43
3590,16,1160874,8234,8277,,43,99.44,2465023.1840707962,1975331.43
3591,16,750000,8234,8306,,72,99.44,2465023.1840707962,1975331.43
3592,17,1500000,8234,8276,,42,99.44,1614143.0049603174,1975331.43
3593,16,1800000,8234,8261,,27,99.44,2465023.1840707962,1975331.43
3594,6,1400000,8234,8278,,44,99.44,1124713.2781954887,1975331.43
3595,11,1000000,8235,8292,,57,99.44,1820371.57,1975331.43
3596,15,1200000,8235,8261,,26,99.44,4522577.48037889,1975331.43
3597,5,1000000,8236,8257,,21,99.44,1400922.5020242915,1975331.43
3598,15,800000,8236,8289,,53,99.44,4522577.48037889,1975331.43
3599,16,800000,8236,8257,,21,99.44,2465023.1840707962,1975331.43
3600,19,1800000,8237,8271,,34,99.44,6721340.5708154505,1975331.43
3601,6,1000000,8237,8303,,66,99.44,1124713.2781954887,1975331.43
3602,16,800000,8237,8346,,109,99.44,2465023.1840707962,1975331.43
3603,10,2500000,8240,8515,,275,99.44,8282326.220930233,1975331.43
3604,12,800000,8240,8265,,25,99.44,7658937.101338432,1975331.43
3605,10,2500000,8240,8515,,275,99.44,8282326.220930233,1975331.43
3606,10,2500000,8240,8515,,275,99.44,8282326.220930233,1975331.43
3607,10,2500000,8240,8515,,275,99.44,8282326.220930233,1975331.43
3608,16,1000000,8240,8304,,64,99.44,2465023.1840707962,1975331.43
3609,17,1000000,8240,8487,,247,99.44,1614143.0049603174,1975331.43
3610,13,1000000,8241,8374,,133,99.44,7795654.71978022,1975331.43
3611,16,1000000,8241,8290,,49,99.44,2465023.1840707962,1975331.43
3612,17,1000000,8242,8577,,335,99.44,1614143.0049603174,1975331.43
3613,8,800000,8242,8270,,28,99.44,1501617.2191780822,1975331.43
3614,11,1000000,8242,8305,,63,99.44,1820371.57,1975331.43
3615,11,700000,8242,8299,,57,99.44,1820371.57,1975331.43
3616,15,675000,8244,8305,,61,99.44,4522577.48037889,1975331.43
3617,0,800000,8244,8306,,62,99.44,8418173.322222222,1975331.43
3618,8,3300000,8245,8353,,108,99.44,1501617.2191780822,1975331.43
3619,3,1000000,8247,8389,,142,99.44,9246769.549865229,1975331.43
3620,5,600000,8247,8415,,168,99.44,1400922.5020242915,1975331.43
3621,15,1000000,8248,8324,,76,99.44,4522577.48037889,1975331.43
3622,19,850000,8248,8333,,85,99.44,6721340.5708154505,1975331.43
3623,16,1000000,8248,8305,,57,99.44,2465023.1840707962,1975331.43
3624,1,600000,8249,8303,,54,99.44,3325419.7044334975,1975331.43
3625,11,3000000,8249,8515,,266,99.44,1820371.57,1975331.43
3626,2,950000,8249,8261,,12,99.44,2989003.2716499544,1975331.43
3627,5,900000,8249,8369,,120,99.44,1400922.5020242915,1975331.43
3628,4,600000,8250,8345,,95,99.44,4297914.794871795,1975331.43
3629,4,600000,8250,8341,,91,99.44,4297914.794871795,1975331.43
3630,4,1000000,8250,8604,,354,99.44,4297914.794871795,1975331.43
3631,15,610000,8250,8311,,61,99.44,4522577.48037889,1975331.43
3632,5,600000,8251,8531,,280,99.44,1400922.5020242915,1975331.43
3633,2,1400000,8251,8643,,392,99.44,2989003.2716499544,1975331.43
3634,1,600000,8251,8321,,70,99.44,3325419.7044334975,1975331.43
3635,2,2000000,8254,8605,,351,99.44,2989003.2716499544,1975331.43
3636,2,800000,8254,8605,,351,99.44,2989003.2716499544,1975331.43
3637,2,800000,8254,8605,,351,99.44,2989003.2716499544,1975331.43
3638,2,800000,8254,8605,,351,99.44,2989003.2716499544,1975331.43
3639,23,900000,8254,8275,,21,99.44,5772926.70157068,1975331.43
3640,17,600000,8255,8293,,38,99.44,1614143.0049603174,1975331.43
3641,12,3500000,8255,8320,,65,99.44,7658937.101338432,1975331.43
3642,11,900000,8255,8325,,70,99.44,1820371.57,1975331.43
3643,17,1500000,8255,8597,,342,99.44,1614143.0049603174,1975331.43
3644,18,3500000,8256,8303,,47,99.44,8584355.493548388,1975331.43
3645,15,1200000,8256,8333,,77,99.44,4522577.48037889,1975331.43
3646,2,1000000,8257,8303,,46,99.44,2989003.2716499544,1975331.43
3647,2,800000,8257,8347,,90,99.44,2989003.2716499544,1975331.43
3648,16,1500000,8257,8354,,97,99.44,2465023.1840707962,1975331.43
3649,19,1000000,8257,8300,,43,99.44,6721340.5708154505,1975331.43
3650,7,600000,8258,8327,,69,99.44,3738553.685483871,1975331.43
3651,11,1000000,8258,8331,,73,99.44,1820371.57,1975331.43
3652,5,550000,8258,8523,,265,99.44,1400922.5020242915,1975331.43
3653,5,550000,8258,8537,,279,99.44,1400922.5020242915,1975331.43
3654,1,600000,8261,8279,,18,99.44,3325419.7044334975,1975331.43
3655,11,695000,8262,8419,,157,99.44,1820371.57,1975331.43
3656,9,800000,8263,8305,,42,99.44,3707403.8834951455,1975331.43
3657,19,1000000,8263,8326,,63,99.44,6721340.5708154505,1975331.43
3658,16,1100000,8263,8418,,155,99.44,2465023.1840707962,1975331.43
3659,1,800000,8264,8320,,56,99.44,3325419.7044334975,1975331.43
3660,10,700000,8264,8342,,78,99.44,8282326.220930233,1975331.43
3661,11,1500000,8264,8298,,34,99.44,1820371.57,1975331.43
3662,22,800000,8264,8319,,55,99.44,2904103.2512077293,1975331.43
3663,4,1500000,8264,8685,,421,99.44,4297914.794871795,1975331.43
3664,23,700000,8265,8283,,18,99.44,5772926.70157068,1975331.43
3665,2,900000,8265,8306,,41,99.44,2989003.2716499544,1975331.43
3666,2,1500000,8269,8424,,155,99.44,2989003.2716499544,1975331.43
3667,12,3000000,8269,8482,,213,99.44,7658937.101338432,1975331.43
3668,15,550000,8269,8313,,44,99.44,4522577.48037889,1975331.43
3669,12,1500000,8269,8296,,27,99.44,7658937.101338432,1975331.43
3670,18,750000,8270,8306,,36,99.44,8584355.493548388,1975331.43
3671,2,800000,8270,8320,,50,99.44,2989003.2716499544,1975331.43
3672,12,1000000,8270,8433,,163,99.44,7658937.101338432,1975331.43
3673,23,700000,8271,8331,,60,99.44,5772926.70157068,1975331.43
3674,11,1500000,8271,8335,,64,99.44,1820371.57,1975331.43
3675,17,1200000,8272,8681,,409,99.44,1614143.0049603174,1975331.43
3676,9,675000,8272,8436,,164,99.44,3707403.8834951455,1975331.43
3677,6,700000,8272,8374,,102,99.44,1124713.2781954887,1975331.43
3678,21,1500000,8272,8303,,31,99.44,17091199.984,1975331.43
3679,12,1000000,8275,8326,,51,99.44,7658937.101338432,1975331.43
3680,2,900000,8275,8299,,24,99.44,2989003.2716499544,1975331.43
3681,2,1000000,8275,8341,,66,99.44,2989003.2716499544,1975331.43
3682,1,750000,8276,8303,,27,99.44,3325419.7044334975,1975331.43
3683,11,1000000,8277,8340,,63,99.44,1820371.57,1975331.43
3684,12,2000000,8278,8345,,67,99.44,7658937.101338432,1975331.43
3685,12,600000,8279,8291,,12,99.44,7658937.101338432,1975331.43
3686,12,600000,8279,8482,,203,99.44,7658937.101338432,1975331.43
3687,8,750000,8279,8698,,419,99.44,1501617.2191780822,1975331.43
3688,12,600000,8279,8482,,203,99.44,7658937.101338432,1975331.43
3689,15,600000,8280,8390,,110,99.44,4522577.48037889,1975331.43
3690,12,700000,8281,8297,,16,99.44,7658937.101338432,1975331.43
3691,12,700000,8281,8297,,16,99.44,7658937.101338432,1975331.43
3692,12,700000,8281,8286,,5,99.44,7658937.101338432,1975331.43
3693,12,700000,8281,8286,,5,99.44,7658937.101338432,1975331.43
3694,9,750000,8282,8286,,4,99.44,3707403.8834951455,1975331.43
3695,8,1272045,8282,8306,,24,99.44,1501617.2191780822,1975331.43
3696,8,1228000,8283,8349,,66,99.44,1501617.2191780822,1975331.43
3697,18,1000000,8283,8404,,121,99.44,8584355.493548388,1975331.43
3698,12,1000000,8283,8481,,198,99.44,7658937.101338432,1975331.43
3699,2,900000,8284,8471,,187,99.44,2989003.2716499544,1975331.43
3700,4,8500000,8284,8353,,69,99.44,4297914.794871795,1975331.43
3701,16,1000000,8284,8578,,294,99.44,2465023.1840707962,1975331.43
3702,5,800000,8284,8313,,29,99.44,1400922.5020242915,1975331.43
3703,5,6000000,8285,8598,,313,99.44,1400922.5020242915,1975331.43
3704,3,1000000,8285,8328,,43,99.44,9246769.549865229,1975331.43
3705,3,600000,8285,8299,,14,99.44,9246769.549865229,1975331.43
3706,15,600000,8285,8366,,81,99.44,4522577.48037889,1975331.43
3707,12,1700000,8285,8303,,18,99.44,7658937.101338432,1975331.43
3708,22,850000,8286,8366,,80,99.44,2904103.2512077293,1975331.43
3709,17,5000000,8286,8325,,39,99.44,1614143.0049603174,1975331.43
3710,19,1000000,8286,8313,,27,99.44,6721340.5708154505,1975331.43
3711,4,1000000,8289,8326,,37,99.44,4297914.794871795,1975331.43
3712,17,900000,8289,8327,,38,99.44,1614143.0049603174,1975331.43
3713,1,1200000,8289,8457,,168,99.44,3325419.7044334975,1975331.43
3714,11,1500000,8289,8345,,56,99.44,1820371.57,1975331.43
3715,16,900000,8290,8415,,125,99.44,2465023.1840707962,1975331.43
3716,23,800000,8290,8306,,16,99.44,5772926.70157068,1975331.43
3717,5,665080,8290,8466,,176,99.44,1400922.5020242915,1975331.43
3718,12,799348,8291,8332,,41,99.44,7658937.101338432,1975331.43
3719,11,1000000,8291,8412,,121,99.44,1820371.57,1975331.43
3720,22,800000,8291,8377,,86,99.44,2904103.2512077293,1975331.43
3721,2,2120000,8292,8409,,117,99.44,2989003.2716499544,1975331.43
3722,3,1000000,8292,8502,,210,99.44,9246769.549865229,1975331.43
3723,15,1000000,8293,8388,,95,99.44,4522577.48037889,1975331.43
3724,5,800000,8296,8320,,24,99.44,1400922.5020242915,1975331.43
3725,2,750000,8296,8425,,129,99.44,2989003.2716499544,1975331.43
3726,18,950000,8297,8333,,36,99.44,8584355.493548388,1975331.43
3727,3,1200000,8297,8363,,66,99.44,9246769.549865229,1975331.43
3728,2,1000000,8297,8306,,9,99.44,2989003.2716499544,1975331.43
3729,5,700000,8297,8354,,57,99.44,1400922.5020242915,1975331.43
3730,15,1000000,8297,8356,,59,99.44,4522577.48037889,1975331.43
3731,15,600000,8298,8405,,107,99.44,4522577.48037889,1975331.43
3732,14,25000000,8298,8572,,274,99.44,5826416.914893617,1975331.43
3733,11,2000000,8298,8415,,117,99.44,1820371.57,1975331.43
3734,12,600000,8298,8376,,78,99.44,7658937.101338432,1975331.43
3735,4,700000,8298,8394,,96,99.44,4297914.794871795,1975331.43
3736,12,3000000,8299,8473,,174,99.44,7658937.101338432,1975331.43
3737,11,950000,8299,8314,,15,99.44,1820371.57,1975331.43
3738,12,1200000,8299,8522,,223,99.44,7658937.101338432,1975331.43
3739,18,4000000,8299,8369,,70,99.44,8584355.493548388,1975331.43
3740,11,2500000,8300,8376,,76,99.44,1820371.57,1975331.43
3741,16,1500000,8302,8368,,66,99.44,2465023.1840707962,1975331.43
3742,11,1192450,8303,8341,,38,99.44,1820371.57,1975331.43
3743,12,2000000,8303,8317,,14,99.44,7658937.101338432,1975331.43
3744,15,750000,8303,8383,,80,99.44,4522577.48037889,1975331.43
3745,4,875000,8303,8580,,277,99.44,4297914.794871795,1975331.43
3746,12,1000000,8304,8380,,76,99.44,7658937.101338432,1975331.43
3747,2,800000,8305,8605,,300,99.44,2989003.2716499544,1975331.43
3748,2,1100000,8305,8466,,161,99.44,2989003.2716499544,1975331.43
3749,2,800000,8306,8605,,299,99.44,2989003.2716499544,1975331.43
3750,15,1000000,8306,8409,,103,99.44,4522577.48037889,1975331.43
3751,11,1200000,8310,8325,,15,99.44,1820371.57,1975331.43
3752,24,2500000,8312,8354,,42,99.44,23456062.532786883,1975331.43
3753,11,700000,8312,8594,,282,99.44,1820371.57,1975331.43
3754,14,750000,8313,8422,,109,99.44,5826416.914893617,1975331.43
3755,16,950000,8313,8370,,57,99.44,2465023.1840707962,1975331.43
3756,11,900000,8314,8348,,34,99.44,1820371.57,1975331.43
3757,2,1000000,8314,8412,,98,99.44,2989003.2716499544,1975331.43
3758,2,1000000,8314,8417,,103,99.44,2989003.2716499544,1975331.43
3759,4,550000,8314,8513,,199,99.44,4297914.794871795,1975331.43
3760,11,850000,8315,8339,,24,99.44,1820371.57,1975331.43
3761,16,900000,8317,8394,,77,99.44,2465023.1840707962,1975331.43
3762,17,1000000,8318,8354,,36,99.44,1614143.0049603174,1975331.43
3763,17,600000,8318,8409,,91,99.44,1614143.0049603174,1975331.43
3764,15,1000000,8319,8375,,56,99.44,4522577.48037889,1975331.43
3765,2,700000,8319,8377,,58,99.44,2989003.2716499544,1975331.43
3766,16,1305600,8320,8362,,42,99.44,2465023.1840707962,1975331.43
3767,15,850000,8321,8347,,26,99.44,4522577.48037889,1975331.43
3768,4,600000,8324,8368,,44,99.44,4297914.794871795,1975331.43
3769,15,1200000,8324,8417,,93,99.44,4522577.48037889,1975331.43
3770,2,700000,8324,8376,,52,99.44,2989003.2716499544,1975331.43
3771,8,900000,8324,8394,,70,99.44,1501617.2191780822,1975331.43
3772,23,900000,8325,8369,,44,99.44,5772926.70157068,1975331.43
3773,11,8000000,8325,8556,,231,99.44,1820371.57,1975331.43
3774,2,1000000,8325,8403,,78,99.44,2989003.2716499544,1975331.43
3775,2,1000000,8325,8403,,78,99.44,2989003.2716499544,1975331.43
3776,24,1600000,8326,8459,,133,99.44,23456062.532786883,1975331.43
3777,17,1065750,8326,8410,,84,99.44,1614143.0049603174,1975331.43
3778,16,2000000,8326,8416,,90,99.44,2465023.1840707962,1975331.43
3779,12,1000000,8326,8403,,77,99.44,7658937.101338432,1975331.43
3780,13,1500000,8327,8580,,253,99.44,7795654.71978022,1975331.43
3781,15,1000000,8327,8460,,133,99.44,4522577.48037889,1975331.43
3782,15,1000000,8327,8394,,67,99.44,4522577.48037889,1975331.43
3783,19,900000,8328,8389,,61,99.44,6721340.5708154505,1975331.43
3784,6,1000000,8328,8423,,95,99.44,1124713.2781954887,1975331.43
3785,22,750000,8328,8402,,74,99.44,2904103.2512077293,1975331.43
3786,14,900000,8331,8821,,490,99.44,5826416.914893617,1975331.43
3787,11,2000000,8331,8500,,169,99.44,1820371.57,1975331.43
3788,17,2120000,8331,8412,,81,99.44,1614143.0049603174,1975331.43
3789,7,1000000,8331,8551,,220,99.44,3738553.685483871,1975331.43
3790,5,650000,8331,8684,,353,99.44,1400922.5020242915,1975331.43
3791,17,750000,8332,8431,,99,99.44,1614143.0049603174,1975331.43
3792,15,1000000,8332,8411,,79,99.44,4522577.48037889,1975331.43
3793,11,900000,8333,8478,,145,99.44,1820371.57,1975331.43
3794,15,1600000,8333,8366,,33,99.44,4522577.48037889,1975331.43
3795,17,1000000,8333,8370,,37,99.44,1614143.0049603174,1975331.43
3796,12,2000000,8333,8366,,33,99.44,7658937.101338432,1975331.43
3797,17,2120000,8334,8471,,137,99.44,1614143.0049603174,1975331.43
3798,16,850000,8334,8348,,14,99.44,2465023.1840707962,1975331.43
3799,2,700000,8334,8370,,36,99.44,2989003.2716499544,1975331.43
3800,15,1000000,8335,8443,,108,99.44,4522577.48037889,1975331.43
3801,17,1100000,8335,8508,,173,99.44,1614143.0049603174,1975331.43
3802,13,1000000,8337,8508,,171,99.44,7795654.71978022,1975331.43
3803,2,900000,8339,8436,,97,99.44,2989003.2716499544,1975331.43
3804,17,2000000,8339,8433,,94,99.44,1614143.0049603174,1975331.43
3805,2,700000,8339,8389,,50,99.44,2989003.2716499544,1975331.43
3806,15,950000,8340,8424,,84,99.44,4522577.48037889,1975331.43
3807,13,636000,8340,8641,,301,99.44,7795654.71978022,1975331.43
3808,12,600000,8340,8418,,78,99.44,7658937.101338432,1975331.43
3809,1,1500000,8340,8395,,55,99.44,3325419.7044334975,1975331.43
3810,11,1000000,8340,8446,,106,99.44,1820371.57,1975331.43
3811,22,800000,8340,8464,,124,99.44,2904103.2512077293,1975331.43
3812,22,750000,8341,8618,,277,99.44,2904103.2512077293,1975331.43
3813,17,1000000,8341,8377,,36,99.44,1614143.0049603174,1975331.43
3814,23,1000000,8342,8368,,26,99.44,5772926.70157068,1975331.43
3815,3,800000,8345,8711,,366,99.44,9246769.549865229,1975331.43
3816,2,1800000,8346,8416,,70,99.44,2989003.2716499544,1975331.43
3817,16,700000,8346,8436,,90,99.44,2465023.1840707962,1975331.43
3818,2,1000000,8346,8457,,111,99.44,2989003.2716499544,1975331.43
3819,12,1000000,8346,8452,,106,99.44,7658937.101338432,1975331.43
3820,16,1250000,8346,8565,,219,99.44,2465023.1840707962,1975331.43
3821,2,2120000,8346,8394,,48,99.44,2989003.2716499544,1975331.43
3822,20,1000000,8347,8513,,166,99.44,7597088.421768707,1975331.43
3823,17,1500000,8347,8411,,64,99.44,1614143.0049603174,1975331.43
3824,1,1000000,8347,8430,,83,99.44,3325419.7044334975,1975331.43
3825,17,6000000,8348,8670,,322,99.44,1614143.0049603174,1975331.43
3826,11,850000,8349,8411,,62,99.44,1820371.57,1975331.43
3827,17,1500000,8349,8389,,40,99.44,1614143.0049603174,1975331.43
3828,3,2000000,8349,8401,,52,99.44,9246769.549865229,1975331.43
3829,16,1100000,8352,8402,,50,99.44,2465023.1840707962,1975331.43
3830,16,800000,8352,8507,,155,99.44,2465023.1840707962,1975331.43
3831,22,800000,8353,8404,,51,99.44,2904103.2512077293,1975331.43
3832,11,700000,8353,8521,,168,99.44,1820371.57,1975331.43
3833,17,750000,8354,8380,,26,99.44,1614143.0049603174,1975331.43
3834,12,1600000,8354,8465,,111,99.44,7658937.101338432,1975331.43
3835,15,700000,8355,8424,,69,99.44,4522577.48037889,1975331.43
3836,11,24700000,8355,8899,,544,99.44,1820371.57,1975331.43
3837,15,700000,8355,8424,,69,99.44,4522577.48037889,1975331.43
3838,22,520000,8355,8465,,110,99.44,2904103.2512077293,1975331.43
3839,22,520000,8355,8464,,109,99.44,2904103.2512077293,1975331.43
3840,15,900000,8356,8404,,48,99.44,4522577.48037889,1975331.43
3841,15,650000,8356,8396,,40,99.44,4522577.48037889,1975331.43
3842,15,1300000,8359,8415,,56,99.44,4522577.48037889,1975331.43
3843,11,1520000,8359,8613,,254,99.44,1820371.57,1975331.43
3844,2,1000000,8360,8389,,29,99.44,2989003.2716499544,1975331.43
3845,17,1500000,8360,8411,,51,99.44,1614143.0049603174,1975331.43
3846,13,850000,8360,8430,,70,99.44,7795654.71978022,1975331.43
3847,13,850000,8361,8424,,63,99.44,7795654.71978022,1975331.43
3848,23,800000,8361,8405,,44,99.44,5772926.70157068,1975331.43
3849,16,700000,8361,8397,,36,99.44,2465023.1840707962,1975331.43
3850,12,800000,8362,8494,,132,99.44,7658937.101338432,1975331.43
3851,2,1500000,8362,8380,,18,99.44,2989003.2716499544,1975331.43
3852,17,1200000,8362,8384,,22,99.44,1614143.0049603174,1975331.43
3853,2,700000,8362,8391,,29,99.44,2989003.2716499544,1975331.43
3854,11,5000000,8363,8405,,42,99.44,1820371.57,1975331.43
3855,24,1000000,8363,8454,,91,99.44,23456062.532786883,1975331.43
3856,9,800000,8365,8410,,45,99.44,3707403.8834951455,1975331.43
3857,11,888300,8365,8410,,45,99.44,1820371.57,1975331.43
3858,15,600000,8366,8429,,63,99.44,4522577.48037889,1975331.43
3859,9,700000,8366,8412,,46,99.44,3707403.8834951455,1975331.43
3860,11,700000,8366,8459,,93,99.44,1820371.57,1975331.43
3861,4,1200000,8367,8391,,24,99.44,4297914.794871795,1975331.43
3862,4,1000000,8367,8433,,66,99.44,4297914.794871795,1975331.43
3863,4,1200000,8368,8439,,71,99.44,4297914.794871795,1975331.43
3864,3,2000000,8368,8457,,89,99.44,9246769.549865229,1975331.43
3865,5,650000,8368,8459,,91,99.44,1400922.5020242915,1975331.43
3866,10,1000000,8368,8388,,20,99.44,8282326.220930233,1975331.43
3867,17,4800000,8369,8558,,189,99.44,1614143.0049603174,1975331.43
3868,24,10000000,8370,8458,,88,99.44,23456062.532786883,1975331.43
3869,17,1000000,8374,8425,,51,99.44,1614143.0049603174,1975331.43
3870,3,660000,8374,8671,,297,99.44,9246769.549865229,1975331.43
3871,11,950000,8374,8424,,50,99.44,1820371.57,1975331.43
3872,11,2000000,8374,8458,,84,99.44,1820371.57,1975331.43
3873,17,2000000,8374,8403,,29,99.44,1614143.0049603174,1975331.43
3874,2,800000,8375,8417,,42,99.44,2989003.2716499544,1975331.43
3875,15,1600000,8375,8478,,103,99.44,4522577.48037889,1975331.43
3876,3,550000,8376,8391,,15,99.44,9246769.549865229,1975331.43
3877,11,1000000,8376,8422,,46,99.44,1820371.57,1975331.43
3878,17,1500000,8376,8411,,35,99.44,1614143.0049603174,1975331.43
3879,15,1000000,8377,8432,,55,99.44,4522577.48037889,1975331.43
3880,16,1000000,8377,8426,,49,99.44,2465023.1840707962,1975331.43
3881,17,1700000,8377,8431,,54,99.44,1614143.0049603174,1975331.43
3882,4,1000000,8377,8437,,60,99.44,4297914.794871795,1975331.43
3883,1,850000,8380,8552,,172,99.44,3325419.7044334975,1975331.43
3884,13,1000000,8380,8422,,42,99.44,7795654.71978022,1975331.43
3885,17,1000000,8380,8415,,35,99.44,1614143.0049603174,1975331.43
3886,6,780000,8381,8415,,34,99.44,1124713.2781954887,1975331.43
3887,17,1000000,8382,8489,,107,99.44,1614143.0049603174,1975331.43
3888,17,1500000,8382,8412,,30,99.44,1614143.0049603174,1975331.43
3889,17,700000,8382,8411,,29,99.44,1614143.0049603174,1975331.43
3890,22,700000,8384,8591,,207,99.44,2904103.2512077293,1975331.43
3891,17,800000,8387,8424,,37,99.44,1614143.0049603174,1975331.43
3892,19,1000000,8387,8468,,81,99.44,6721340.5708154505,1975331.43
3893,18,700000,8388,8423,,35,99.44,8584355.493548388,1975331.43
3894,11,700000,8388,8513,,125,99.44,1820371.57,1975331.43
3895,17,1500000,8389,8502,,113,99.44,1614143.0049603174,1975331.43
3896,23,1000000,8389,8677,,288,99.44,5772926.70157068,1975331.43
3897,6,730000,8389,8482,,93,99.44,1124713.2781954887,1975331.43
3898,0,1200000,8389,8675,,286,99.44,8418173.322222222,1975331.43
3899,13,5000000,8390,8422,,32,99.44,7795654.71978022,1975331.43
3900,6,960000,8390,8439,,49,99.44,1124713.2781954887,1975331.43
3901,23,1000000,8391,8594,,203,99.44,5772926.70157068,1975331.43
3902,4,700000,8391,8510,,119,99.44,4297914.794871795,1975331.43
3903,6,1000000,8394,8446,,52,99.44,1124713.2781954887,1975331.43
3904,15,834600,8394,8536,,142,99.44,4522577.48037889,1975331.43
3905,15,1673640,8394,8436,,42,99.44,4522577.48037889,1975331.43
3906,11,900000,8395,8425,,30,99.44,1820371.57,1975331.43
3907,9,1000000,8395,8467,,72,99.44,3707403.8834951455,1975331.43
3908,2,1400000,8395,8411,,16,99.44,2989003.2716499544,1975331.43
3909,16,1000000,8395,8419,,24,99.44,2465023.1840707962,1975331.43
3910,12,1200000,8396,8422,,26,99.44,7658937.101338432,1975331.43
3911,17,1000000,8396,8454,,58,99.44,1614143.0049603174,1975331.43
3912,11,2000000,8397,8471,,74,99.44,1820371.57,1975331.43
3913,12,1000000,8397,8509,,112,99.44,7658937.101338432,1975331.43
3914,15,750000,8397,8548,,151,99.44,4522577.48037889,1975331.43
3915,15,750000,8397,8550,,153,99.44,4522577.48037889,1975331.43
3916,22,1400000,8400,8479,,79,99.44,2904103.2512077293,1975331.43
3917,11,1200000,8401,8451,,50,99.44,1820371.57,1975331.43
3918,16,1200000,8401,8429,,28,99.44,2465023.1840707962,1975331.43
3919,12,1400000,8401,8822,,421,99.44,7658937.101338432,1975331.43
3920,3,1000000,8402,8429,,27,99.44,9246769.549865229,1975331.43
3921,5,650000,8402,8725,,323,99.44,1400922.5020242915,1975331.43
3922,12,750000,8402,8457,,55,99.44,7658937.101338432,1975331.43
3923,13,1000000,8402,8667,,265,99.44,7795654.71978022,1975331.43
3924,11,1000000,8403,8468,,65,99.44,1820371.57,1975331.43
3925,16,1500000,8403,8467,,64,99.44,2465023.1840707962,1975331.43
3926,5,1000000,8403,8507,,104,99.44,1400922.5020242915,1975331.43
3927,15,750000,8403,8457,,54,99.44,4522577.48037889,1975331.43
3928,17,1000000,8404,8500,,96,99.44,1614143.0049603174,1975331.43
3929,21,6600000,8404,8480,,76,99.44,17091199.984,1975331.43
3930,5,700000,8405,8503,,98,99.44,1400922.5020242915,1975331.43
3931,5,750000,8405,8621,,216,99.44,1400922.5020242915,1975331.43
3932,6,1000000,8405,8535,,130,99.44,1124713.2781954887,1975331.43
3933,19,1200000,8405,8454,,49,99.44,6721340.5708154505,1975331.43
3934,14,1000000,8409,8662,,253,99.44,5826416.914893617,1975331.43
3935,2,1000000,8409,8506,,97,99.44,2989003.2716499544,1975331.43
3936,2,1000000,8409,8506,,97,99.44,2989003.2716499544,1975331.43
3937,2,1000000,8409,8506,,97,99.44,2989003.2716499544,1975331.43
3938,17,1000000,8411,8508,,97,99.44,1614143.0049603174,1975331.43
3939,11,2000000,8411,8544,,133,99.44,1820371.57,1975331.43
3940,15,950000,8411,8453,,42,99.44,4522577.48037889,1975331.43
3941,19,1000000,8411,8461,,50,99.44,6721340.5708154505,1975331.43
3942,16,2000000,8411,8552,,141,99.44,2465023.1840707962,1975331.43
3943,4,1200000,8412,8465,,53,99.44,4297914.794871795,1975331.43
3944,11,1000000,8412,8534,,122,99.44,1820371.57,1975331.43
3945,12,1500000,8412,8432,,20,99.44,7658937.101338432,1975331.43
3946,24,2700000,8412,8543,,131,99.44,23456062.532786883,1975331.43
3947,2,1000000,8412,8454,,42,99.44,2989003.2716499544,1975331.43
3948,8,1000000,8412,8585,,173,99.44,1501617.2191780822,1975331.43
3949,13,1700000,8412,8513,,101,99.44,7795654.71978022,1975331.43
3950,11,1150000,8414,8471,,57,99.44,1820371.57,1975331.43
3951,19,1500000,8415,8522,,107,99.44,6721340.5708154505,1975331.43
3952,17,1500000,8415,8430,,15,99.44,1614143.0049603174,1975331.43
3953,2,1000000,8415,8444,,29,99.44,2989003.2716499544,1975331.43
3954,8,800000,8415,8460,,45,99.44,1501617.2191780822,1975331.43
3955,3,1000000,8415,8496,,81,99.44,9246769.549865229,1975331.43
3956,15,700000,8416,8446,,30,99.44,4522577.48037889,1975331.43
3957,2,1000000,8416,8530,,114,99.44,2989003.2716499544,1975331.43
3958,5,700000,8416,8521,,105,99.44,1400922.5020242915,1975331.43
3959,17,1100000,8417,8447,,30,99.44,1614143.0049603174,1975331.43
3960,16,600000,8417,8515,,98,99.44,2465023.1840707962,1975331.43
3961,6,5500000,8417,8887,,470,99.44,1124713.2781954887,1975331.43
3962,2,900000,8418,8458,,40,99.44,2989003.2716499544,1975331.43
3963,23,900000,8418,8538,,120,99.44,5772926.70157068,1975331.43
3964,22,600000,8419,8537,,118,99.44,2904103.2512077293,1975331.43
3965,5,1000000,8419,8468,,49,99.44,1400922.5020242915,1975331.43
3966,5,600000,8422,8795,,373,99.44,1400922.5020242915,1975331.43
3967,2,1000000,8422,8499,,77,99.44,2989003.2716499544,1975331.43
3968,12,550000,8423,8478,,55,99.44,7658937.101338432,1975331.43
3969,20,1000000,8424,8576,,152,99.44,7597088.421768707,1975331.43
3970,5,800000,8424,8475,,51,99.44,1400922.5020242915,1975331.43
3971,19,800000,8424,8473,,49,99.44,6721340.5708154505,1975331.43
3972,13,900000,8425,8472,,47,99.44,7795654.71978022,1975331.43
3973,23,850000,8425,8752,,327,99.44,5772926.70157068,1975331.43
3974,16,830000,8426,8447,,21,99.44,2465023.1840707962,1975331.43
3975,2,5000000,8426,8531,,105,99.44,2989003.2716499544,1975331.43
3976,2,1000000,8426,8452,,26,99.44,2989003.2716499544,1975331.43
3977,17,800000,8429,8734,,305,99.44,1614143.0049603174,1975331.43
3978,17,1000000,8429,8461,,32,99.44,1614143.0049603174,1975331.43
3979,1,1000000,8429,8457,,28,99.44,3325419.7044334975,1975331.43
3980,24,23000000,8430,8507,,77,99.44,23456062.532786883,1975331.43
3981,3,800000,8431,8496,,65,99.44,9246769.549865229,1975331.43
3982,14,1000000,8431,8613,,182,99.44,5826416.914893617,1975331.43
3983,12,1000000,8431,8482,,51,99.44,7658937.101338432,1975331.43
3984,11,750000,8433,8510,,77,99.44,1820371.57,1975331.43
3985,5,1000000,8433,8647,,214,99.44,1400922.5020242915,1975331.43
3986,7,1270000,8433,8531,,98,99.44,3738553.685483871,1975331.43
3987,2,800000,8436,8479,,43,99.44,2989003.2716499544,1975331.43
3988,22,650000,8436,8781,,345,99.44,2904103.2512077293,1975331.43
3989,12,1500000,8436,8458,,22,99.44,7658937.101338432,1975331.43
3990,17,1500000,8436,8615,,179,99.44,1614143.0049603174,1975331.43
3991,2,1000000,8437,8500,,63,99.44,2989003.2716499544,1975331.43
3992,9,1000000,8437,8459,,22,99.44,3707403.8834951455,1975331.43
3993,1,800000,8437,8643,,206,99.44,3325419.7044334975,1975331.43
3994,15,900000,8437,8499,,62,99.44,4522577.48037889,1975331.43
3995,11,2500000,8438,8508,,70,99.44,1820371.57,1975331.43
3996,2,1000000,8439,8891,,452,99.44,2989003.2716499544,1975331.43
3997,15,750000,8439,8474,,35,99.44,4522577.48037889,1975331.43
3998,15,2000000,8444,8499,,55,99.44,4522577.48037889,1975331.43
3999,9,1000000,8444,8577,,133,99.44,3707403.8834951455,1975331.43
4000,14,1000000,8444,8527,,83,99.44,5826416.914893617,1975331.43
4001,21,2000000,8444,8474,,30,99.44,17091199.984,1975331.43
4002,5,560000,8445,8548,,103,99.44,1400922.5020242915,1975331.43
4003,11,960000,8445,8467,,22,99.44,1820371.57,1975331.43
4004,5,1000000,8445,8599,,154,99.44,1400922.5020242915,1975331.43
4005,19,1000000,8446,8604,,158,99.44,6721340.5708154505,1975331.43
4006,11,1000000,8446,8577,,131,99.44,1820371.57,1975331.43
4007,2,800000,8446,8605,,159,99.44,2989003.2716499544,1975331.43
4008,2,800000,8446,8605,,159,99.44,2989003.2716499544,1975331.43
4009,5,1000000,8447,8529,,82,99.44,1400922.5020242915,1975331.43
4010,5,1000000,8447,8535,,88,99.44,1400922.5020242915,1975331.43
4011,1,850000,8450,8636,,186,99.44,3325419.7044334975,1975331.43
4012,1,1500000,8450,8508,,58,99.44,3325419.7044334975,1975331.43
4013,11,1800000,8450,8668,,218,99.44,1820371.57,1975331.43
4014,14,1000000,8451,8664,,213,99.44,5826416.914893617,1975331.43
4015,11,2000000,8452,8562,,110,99.44,1820371.57,1975331.43
4016,21,5000000,8453,8495,,42,99.44,17091199.984,1975331.43
4017,17,650000,8453,8494,,41,99.44,1614143.0049603174,1975331.43
4018,14,973000,8453,8702,,249,99.44,5826416.914893617,1975331.43
4019,11,1200000,8454,8500,,46,99.44,1820371.57,1975331.43
4020,5,700000,8457,8643,,186,99.44,1400922.5020242915,1975331.43
4021,11,2000000,8457,8544,,87,99.44,1820371.57,1975331.43
4022,11,1000000,8459,8507,,48,99.44,1820371.57,1975331.43
4023,6,800000,8459,8555,,96,99.44,1124713.2781954887,1975331.43
4024,6,800000,8459,8566,,107,99.44,1124713.2781954887,1975331.43
4025,15,1000000,8459,8535,,76,99.44,4522577.48037889,1975331.43
4026,16,900000,8459,8481,,22,99.44,2465023.1840707962,1975331.43
4027,15,1200000,8459,8545,,86,99.44,4522577.48037889,1975331.43
4028,17,850000,8460,8494,,34,99.44,1614143.0049603174,1975331.43
4029,17,2000000,8460,8577,,117,99.44,1614143.0049603174,1975331.43
4030,12,600000,8461,8625,,164,99.44,7658937.101338432,1975331.43
4031,12,600000,8461,8626,,165,99.44,7658937.101338432,1975331.43
4032,16,1500000,8465,8576,,111,99.44,2465023.1840707962,1975331.43
4033,12,1000000,8465,8502,,37,99.44,7658937.101338432,1975331.43
4034,6,800000,8465,8635,,170,99.44,1124713.2781954887,1975331.43
4035,12,1500000,8466,8479,,13,99.44,7658937.101338432,1975331.43
4036,11,900000,8466,8559,,93,99.44,1820371.57,1975331.43
4037,20,600000,8466,8646,,180,99.44,7597088.421768707,1975331.43
4038,12,798000,8466,8507,,41,99.44,7658937.101338432,1975331.43
4039,9,1000000,8467,8549,,82,99.44,3707403.8834951455,1975331.43
4040,2,1500000,8467,8488,,21,99.44,2989003.2716499544,1975331.43
4041,5,700000,8468,8529,,61,99.44,1400922.5020242915,1975331.43
4042,11,2000000,8468,8516,,48,99.44,1820371.57,1975331.43
4043,6,800000,8472,8601,,129,99.44,1124713.2781954887,1975331.43
4044,11,1500000,8472,8499,,27,99.44,1820371.57,1975331.43
4045,17,820000,8473,8480,,7,99.44,1614143.0049603174,1975331.43
4046,13,509645,8473,8487,,14,99.44,7795654.71978022,1975331.43
4047,17,1000000,8473,8661,,188,99.44,1614143.0049603174,1975331.43
4048,19,1500000,8473,8738,,265,99.44,6721340.5708154505,1975331.43
4049,4,750000,8475,8550,,75,99.44,4297914.794871795,1975331.43
4050,19,1000000,8475,8569,,94,99.44,6721340.5708154505,1975331.43
4051,12,2200000,8475,8502,,27,99.44,7658937.101338432,1975331.43
4052,11,1000000,8478,8529,,51,99.44,1820371.57,1975331.43
4053,23,1000000,8480,8718,,238,99.44,5772926.70157068,1975331.43
4054,2,700000,8480,8555,,75,99.44,2989003.2716499544,1975331.43
4055,15,750000,8480,8499,,19,99.44,4522577.48037889,1975331.43
4056,17,900000,8481,8572,,91,99.44,1614143.0049603174,1975331.43
4057,2,1100000,8481,8635,,154,99.44,2989003.2716499544,1975331.43
4058,15,950000,8481,8611,,130,99.44,4522577.48037889,1975331.43
4059,15,835800,8482,8531,,49,99.44,4522577.48037889,1975331.43
4060,2,783800,8482,8521,,39,99.44,2989003.2716499544,1975331.43
4061,12,1000000,8487,8517,,30,99.44,7658937.101338432,1975331.43
4062,15,900000,8488,8573,,85,99.44,4522577.48037889,1975331.43
4063,17,1500000,8488,8566,,78,99.44,1614143.0049603174,1975331.43
4064,2,800000,8488,8853,,365,99.44,2989003.2716499544,1975331.43
4065,2,1000000,8489,8543,,54,99.44,2989003.2716499544,1975331.43
4066,14,900000,8493,8517,,24,65.64,5826416.914893617,1503028.14
4067,18,1000000,8494,8593,,99,65.64,8584355.493548388,1503028.14
4068,2,1000000,8494,8534,,40,65.64,2989003.2716499544,1503028.14
4069,15,1200000,8494,8523,,29,65.64,4522577.48037889,1503028.14
4070,6,2000000,8494,8536,,42,65.64,1124713.2781954887,1503028.14
4071,2,1200000,8495,8684,,189,65.64,2989003.2716499544,1503028.14
4072,1,690000,8496,8601,,105,65.64,3325419.7044334975,1503028.14
4073,9,700000,8496,8618,,122,65.64,3707403.8834951455,1503028.14
4074,2,900000,8499,8558,,59,65.64,2989003.2716499544,1503028.14
4075,2,832000,8499,8537,,38,65.64,2989003.2716499544,1503028.14
4076,5,1000000,8500,8559,,59,65.64,1400922.5020242915,1503028.14
4077,15,1000000,8501,8654,,153,65.64,4522577.48037889,1503028.14
4078,15,1000000,8501,8677,,176,65.64,4522577.48037889,1503028.14
4079,17,800000,8502,8549,,47,65.64,1614143.0049603174,1503028.14
4080,17,1500000,8502,8545,,43,65.64,1614143.0049603174,1503028.14
4081,1,1600000,8506,8654,,148,65.64,3325419.7044334975,1503028.14
4082,6,510000,8507,8598,,91,65.64,1124713.2781954887,1503028.14
4083,23,1300000,8508,8583,,75,65.64,5772926.70157068,1503028.14
4084,12,1500000,8508,8634,,126,65.64,7658937.101338432,1503028.14
4085,1,1100000,8509,8572,,63,65.64,3325419.7044334975,1503028.14
4086,17,800000,8510,8556,,46,65.64,1614143.0049603174,1503028.14
4087,11,1000000,8510,8535,,25,65.64,1820371.57,1503028.14
4088,11,750000,8510,8531,,21,65.64,1820371.57,1503028.14
4089,23,750000,8510,8520,,10,65.64,5772926.70157068,1503028.14
4090,12,1000000,8513,8555,,42,65.64,7658937.101338432,1503028.14
4091,15,800000,8513,8591,,78,65.64,4522577.48037889,1503028.14
4092,22,1000000,8515,8571,,56,65.64,2904103.2512077293,1503028.14
4093,22,1000000,8515,8571,,56,65.64,2904103.2512077293,1503028.14
4094,11,1000000,8515,8585,,70,65.64,1820371.57,1503028.14
4095,17,1200000,8515,8643,,128,65.64,1614143.0049603174,1503028.14
4096,15,750000,8517,8591,,74,65.64,4522577.48037889,1503028.14
4097,16,1200000,8517,8741,,224,65.64,2465023.1840707962,1503028.14
4098,21,48000000,8520,8555,,35,65.64,17091199.984,1503028.14
4099,4,1000000,8520,8641,,121,65.64,4297914.794871795,1503028.14
4100,4,1000000,8520,8642,,122,65.64,4297914.794871795,1503028.14
4101,12,1000000,8521,8619,,98,65.64,7658937.101338432,1503028.14
4102,11,700000,8521,8649,,128,65.64,1820371.57,1503028.14
4103,17,750000,8521,8565,,44,65.64,1614143.0049603174,1503028.14
4104,22,800000,8521,8655,,134,65.64,2904103.2512077293,1503028.14
4105,15,850000,8521,8698,,177,65.64,4522577.48037889,1503028.14
4106,23,927500,8522,8685,,163,65.64,5772926.70157068,1503028.14
4107,21,2000000,8522,8894,,372,65.64,17091199.984,1503028.14
4108,16,850000,8522,8552,,30,65.64,2465023.1840707962,1503028.14
4109,16,675000,8523,8571,,48,65.64,2465023.1840707962,1503028.14
4110,19,700000,8523,8626,,103,65.64,6721340.5708154505,1503028.14
4111,11,1200000,8524,8662,,138,65.64,1820371.57,1503028.14
4112,1,800000,8524,8604,,80,65.64,3325419.7044334975,1503028.14
4113,23,750000,8527,8646,,119,65.64,5772926.70157068,1503028.14
4114,2,900000,8527,8549,,22,65.64,2989003.2716499544,1503028.14
4115,17,1000000,8527,8690,,163,65.64,1614143.0049603174,1503028.14
4116,2,1000000,8528,8601,,73,65.64,2989003.2716499544,1503028.14
4117,24,1000000,8528,8549,,21,65.64,23456062.532786883,1503028.14
4118,2,1000000,8528,8621,,93,65.64,2989003.2716499544,1503028.14
4119,19,1400000,8529,8565,,36,65.64,6721340.5708154505,1503028.14
4120,23,1000000,8530,8634,,104,65.64,5772926.70157068,1503028.14
4121,11,700000,8530,8593,,63,65.64,1820371.57,1503028.14
4122,13,768435,8531,8712,,181,65.64,7795654.71978022,1503028.14
4123,6,800000,8534,8551,,17,65.64,1124713.2781954887,1503028.14
4124,19,800000,8534,8570,,36,65.64,6721340.5708154505,1503028.14
4125,12,1000000,8534,8653,,119,65.64,7658937.101338432,1503028.14
4126,16,1000000,8534,8818,,284,65.64,2465023.1840707962,1503028.14
4127,17,900000,8534,8583,,49,65.64,1614143.0049603174,1503028.14
4128,3,1300000,8535,8601,,66,65.64,9246769.549865229,1503028.14
4129,17,875000,8535,8583,,48,65.64,1614143.0049603174,1503028.14
4130,17,1850000,8535,8597,,62,65.64,1614143.0049603174,1503028.14
4131,6,900000,8535,8643,,108,65.64,1124713.2781954887,1503028.14
4132,4,1200000,8535,8604,,69,65.64,4297914.794871795,1503028.14
4133,5,550000,8536,8627,,91,65.64,1400922.5020242915,1503028.14
4134,15,625000,8536,8564,,28,65.64,4522577.48037889,1503028.14
4135,12,750000,8536,8559,,23,65.64,7658937.101338432,1503028.14
4136,11,1000000,8536,8605,,69,65.64,1820371.57,1503028.14
4137,13,1608200,8536,8598,,62,65.64,7795654.71978022,1503028.14
4138,19,1000000,8537,8570,,33,65.64,6721340.5708154505,1503028.14
4139,22,600000,8538,8580,,42,65.64,2904103.2512077293,1503028.14
4140,23,550000,8542,8643,,101,65.64,5772926.70157068,1503028.14
4141,23,550000,8542,8705,,163,65.64,5772926.70157068,1503028.14
4142,2,1000000,8543,8629,,86,65.64,2989003.2716499544,1503028.14
4143,11,600000,8543,8627,,84,65.64,1820371.57,1503028.14
4144,11,1000000,8543,8640,,97,65.64,1820371.57,1503028.14
4145,16,1000000,8543,8619,,76,65.64,2465023.1840707962,1503028.14
4146,11,1000000,8544,8636,,92,65.64,1820371.57,1503028.14
4147,9,1200000,8544,8573,,29,65.64,3707403.8834951455,1503028.14
4148,17,800000,8544,8614,,70,65.64,1614143.0049603174,1503028.14
4149,3,650000,8545,8570,,25,65.64,9246769.549865229,1503028.14
4150,1,700000,8545,8625,,80,65.64,3325419.7044334975,1503028.14
4151,16,900000,8548,8562,,14,65.64,2465023.1840707962,1503028.14
4152,1,1000000,8548,8824,,276,65.64,3325419.7044334975,1503028.14
4153,11,1198000,8548,8570,,22,65.64,1820371.57,1503028.14
4154,9,1000000,8548,8892,,344,65.64,3707403.8834951455,1503028.14
4155,24,1100000,8548,8689,,141,65.64,23456062.532786883,1503028.14
4156,17,850000,8548,8606,,58,65.64,1614143.0049603174,1503028.14
4157,17,850000,8548,8656,,108,65.64,1614143.0049603174,1503028.14
4158,2,1000000,8549,8675,,126,65.64,2989003.2716499544,1503028.14
4159,15,750000,8549,8643,,94,65.64,4522577.48037889,1503028.14
4160,17,1000000,8550,8572,,22,65.64,1614143.0049603174,1503028.14
4161,17,1000000,8550,8583,,33,65.64,1614143.0049603174,1503028.14
4162,5,1000000,8550,8641,,91,65.64,1400922.5020242915,1503028.14
4163,22,690000,8550,8585,,35,65.64,2904103.2512077293,1503028.14
4164,2,1200000,8550,8607,,57,65.64,2989003.2716499544,1503028.14
4165,15,1500000,8551,8570,,19,65.64,4522577.48037889,1503028.14
4166,17,800000,8551,8599,,48,65.64,1614143.0049603174,1503028.14
4167,19,2500000,8552,8585,,33,65.64,6721340.5708154505,1503028.14
4168,17,1000000,8552,8584,,32,65.64,1614143.0049603174,1503028.14
4169,12,1000000,8555,8579,,24,65.64,7658937.101338432,1503028.14
4170,15,800000,8556,8614,,58,65.64,4522577.48037889,1503028.14
4171,5,600000,8556,8618,,62,65.64,1400922.5020242915,1503028.14
4172,3,3010000,8556,8619,,63,65.64,9246769.549865229,1503028.14
4173,12,1000000,8557,8646,,89,65.64,7658937.101338432,1503028.14
4174,17,1300000,8557,8578,,21,65.64,1614143.0049603174,1503028.14
4175,1,600000,8558,8591,,33,65.64,3325419.7044334975,1503028.14
4176,13,600000,8561,8648,,87,65.64,7795654.71978022,1503028.14
4177,15,600000,8562,8612,,50,65.64,4522577.48037889,1503028.14
4178,17,600000,8562,8608,,46,65.64,1614143.0049603174,1503028.14
4179,2,1000000,8563,8753,,190,65.64,2989003.2716499544,1503028.14
4180,3,2500000,8563,8643,,80,65.64,9246769.549865229,1503028.14
4181,17,1200000,8563,8633,,70,65.64,1614143.0049603174,1503028.14
4182,11,1150000,8563,8626,,63,65.64,1820371.57,1503028.14
4183,12,1000000,8564,8615,,51,65.64,7658937.101338432,1503028.14
4184,16,2000000,8566,8669,,103,65.64,2465023.1840707962,1503028.14
4185,19,1200000,8566,8642,,76,65.64,6721340.5708154505,1503028.14
4186,17,1500000,8566,8634,,68,65.64,1614143.0049603174,1503028.14
4187,22,750000,8569,8606,,37,65.64,2904103.2512077293,1503028.14
4188,14,700000,8569,8643,,74,65.64,5826416.914893617,1503028.14
4189,15,800000,8569,8634,,65,65.64,4522577.48037889,1503028.14
4190,21,760000,8570,8607,,37,65.64,17091199.984,1503028.14
4191,17,800000,8570,8635,,65,65.64,1614143.0049603174,1503028.14
4192,17,800000,8570,8675,,105,65.64,1614143.0049603174,1503028.14
4193,11,700000,8570,8593,,23,65.64,1820371.57,1503028.14
4194,17,800000,8571,8612,,41,65.64,1614143.0049603174,1503028.14
4195,11,1000000,8571,8607,,36,65.64,1820371.57,1503028.14
4196,12,1000000,8572,8625,,53,65.64,7658937.101338432,1503028.14
4197,19,1050000,8573,8804,,231,65.64,6721340.5708154505,1503028.14
4198,2,900000,8573,8593,,20,65.64,2989003.2716499544,1503028.14
4199,21,600000,8573,8606,,33,65.64,17091199.984,1503028.14
4200,17,1600000,8576,8599,,23,65.64,1614143.0049603174,1503028.14
4201,17,1500000,8576,8804,,228,65.64,1614143.0049603174,1503028.14
4202,11,900000,8576,8648,,72,65.64,1820371.57,1503028.14
4203,11,1000000,8577,8656,,79,65.64,1820371.57,1503028.14
4204,17,800000,8577,8676,,99,65.64,1614143.0049603174,1503028.14
4205,13,1000000,8577,8636,,59,65.64,7795654.71978022,1503028.14
4206,23,850000,8578,8620,,42,65.64,5772926.70157068,1503028.14
4207,3,800000,8578,8682,,104,65.64,9246769.549865229,1503028.14
4208,3,800000,8578,8682,,104,65.64,9246769.549865229,1503028.14
4209,2,1000000,8578,8598,,20,65.64,2989003.2716499544,1503028.14
4210,19,850000,8578,8598,,20,65.64,6721340.5708154505,1503028.14
4211,2,900000,8580,8668,,88,65.64,2989003.2716499544,1503028.14
4212,7,800000,8580,8612,,32,65.64,3738553.685483871,1503028.14
4213,16,2155000,8583,8661,,78,65.64,2465023.1840707962,1503028.14
4214,17,1000000,8583,8695,,112,65.64,1614143.0049603174,1503028.14
4215,16,1000000,8583,8619,,36,65.64,2465023.1840707962,1503028.14
4216,24,800000,8583,8642,,59,65.64,23456062.532786883,1503028.14
4217,5,857350,8583,8622,,39,65.64,1400922.5020242915,1503028.14
4218,11,1500000,8584,8641,,57,65.64,1820371.57,1503028.14
4219,1,850000,8584,8605,,21,65.64,3325419.7044334975,1503028.14
4220,16,740000,8586,8675,,89,65.64,2465023.1840707962,1503028.14
4221,3,1000000,8586,8604,,18,65.64,9246769.549865229,1503028.14
4222,2,1000000,8586,8758,,172,65.64,2989003.2716499544,1503028.14
4223,2,625000,8586,8863,,277,65.64,2989003.2716499544,1503028.14
4224,19,1000000,8591,8639,,48,65.64,6721340.5708154505,1503028.14
4225,15,1400000,8591,8642,,51,65.64,4522577.48037889,1503028.14
4226,2,1495000,8591,8618,,27,65.64,2989003.2716499544,1503028.14
4227,17,600000,8592,8654,,62,65.64,1614143.0049603174,1503028.14
4228,11,900000,8592,8758,,166,65.64,1820371.57,1503028.14
4229,4,750000,8592,8635,,43,65.64,4297914.794871795,1503028.14
4230,2,1000000,8592,8633,,41,65.64,2989003.2716499544,1503028.14
4231,11,2000000,8592,8669,,77,65.64,1820371.57,1503028.14
4232,2,600000,8593,8678,,85,65.64,2989003.2716499544,1503028.14
4233,15,750000,8593,8681,,88,65.64,4522577.48037889,1503028.14
4234,13,800000,8593,8634,,41,65.64,7795654.71978022,1503028.14
4235,20,1000000,8593,8692,,99,65.64,7597088.421768707,1503028.14
4236,17,800000,8594,8642,,48,65.64,1614143.0049603174,1503028.14
4237,16,1000000,8594,8656,,62,65.64,2465023.1840707962,1503028.14
4238,6,800000,8594,8646,,52,65.64,1124713.2781954887,1503028.14
4239,12,1000000,8597,8621,,24,65.64,7658937.101338432,1503028.14
4240,3,1900000,8597,8640,,43,65.64,9246769.549865229,1503028.14
4241,2,1000000,8598,8612,,14,65.64,2989003.2716499544,1503028.14
4242,4,600000,8598,8613,,15,65.64,4297914.794871795,1503028.14
4243,17,1200000,8598,8647,,49,65.64,1614143.0049603174,1503028.14
4244,20,700000,8598,8661,,63,65.64,7597088.421768707,1503028.14
4245,18,750000,8599,8677,,78,65.64,8584355.493548388,1503028.14
4246,17,1000000,8599,8643,,44,65.64,1614143.0049603174,1503028.14
4247,5,800000,8599,8705,,106,65.64,1400922.5020242915,1503028.14
4248,23,1000000,8599,8621,,22,65.64,5772926.70157068,1503028.14
4249,2,900000,8599,8639,,40,65.64,2989003.2716499544,1503028.14
4250,17,1200000,8600,8629,,29,65.64,1614143.0049603174,1503028.14
4251,17,800000,8600,8643,,43,65.64,1614143.0049603174,1503028.14
4252,12,2500000,8600,8618,,18,65.64,7658937.101338432,1503028.14
4253,16,800000,8601,8667,,66,65.64,2465023.1840707962,1503028.14
4254,17,1000000,8601,8639,,38,65.64,1614143.0049603174,1503028.14
4255,5,600000,8604,8642,,38,65.64,1400922.5020242915,1503028.14
4256,15,1000000,8604,8681,,77,65.64,4522577.48037889,1503028.14
4257,6,650000,8604,8745,,141,65.64,1124713.2781954887,1503028.14
4258,2,700000,8604,8690,,86,65.64,2989003.2716499544,1503028.14
4259,24,600000,8604,8612,,8,65.64,23456062.532786883,1503028.14
4260,15,750000,8605,8733,,128,65.64,4522577.48037889,1503028.14
4261,12,1500000,8605,8668,,63,65.64,7658937.101338432,1503028.14
4262,22,650000,8605,8663,,58,65.64,2904103.2512077293,1503028.14
4263,9,750000,8605,8710,,105,65.64,3707403.8834951455,1503028.14
4264,19,700000,8605,8621,,16,65.64,6721340.5708154505,1503028.14
4265,22,800000,8606,8677,,71,65.64,2904103.2512077293,1503028.14
4266,15,1000000,8606,8685,,79,65.64,4522577.48037889,1503028.14
4267,5,560000,8606,8781,,175,65.64,1400922.5020242915,1503028.14
4268,16,1700000,8606,8656,,50,65.64,2465023.1840707962,1503028.14
4269,15,1000000,8607,8642,,35,65.64,4522577.48037889,1503028.14
4270,17,1600000,8607,8682,,75,65.64,1614143.0049603174,1503028.14
4271,11,1000000,8607,8677,,70,65.64,1820371.57,1503028.14
4272,17,1500000,8608,8636,,28,65.64,1614143.0049603174,1503028.14
4273,1,1200000,8608,8676,,68,65.64,3325419.7044334975,1503028.14
4274,15,700000,8611,8718,,107,65.64,4522577.48037889,1503028.14
4275,4,750000,8612,8681,,69,65.64,4297914.794871795,1503028.14
4276,14,950000,8612,8730,,118,65.64,5826416.914893617,1503028.14
4277,4,750000,8612,8681,,69,65.64,4297914.794871795,1503028.14
4278,2,1500000,8612,8789,,177,65.64,2989003.2716499544,1503028.14
4279,11,1000000,8612,8663,,51,65.64,1820371.57,1503028.14
4280,11,850000,8612,8629,,17,65.64,1820371.57,1503028.14
4281,12,3000000,8612,8740,,128,65.64,7658937.101338432,1503028.14
4282,11,1000000,8612,8648,,36,65.64,1820371.57,1503028.14
4283,14,1395000,8613,8641,,28,65.64,5826416.914893617,1503028.14
4284,12,1000000,8613,8661,,48,65.64,7658937.101338432,1503028.14
4285,2,815200,8613,8717,,104,65.64,2989003.2716499544,1503028.14
4286,11,850000,8614,8635,,21,65.64,1820371.57,1503028.14
4287,1,7800000,8614,8685,,71,65.64,3325419.7044334975,1503028.14
4288,11,850000,8615,8642,,27,65.64,1820371.57,1503028.14
4289,15,800000,8615,8767,,152,65.64,4522577.48037889,1503028.14
4290,15,800000,8615,8795,,180,65.64,4522577.48037889,1503028.14
4291,15,750000,8618,8660,,42,65.64,4522577.48037889,1503028.14
4292,16,1080000,8618,8648,,30,65.64,2465023.1840707962,1503028.14
4293,17,1288860,8618,8649,,31,65.64,1614143.0049603174,1503028.14
4294,17,1600000,8619,8746,,127,65.64,1614143.0049603174,1503028.14
4295,6,800000,8619,8811,,192,65.64,1124713.2781954887,1503028.14
4296,17,1000000,8620,8639,,19,65.64,1614143.0049603174,1503028.14
4297,2,1000000,8620,8702,,82,65.64,2989003.2716499544,1503028.14
4298,4,1200000,8620,8669,,49,65.64,4297914.794871795,1503028.14
4299,18,1000000,8621,8676,,55,65.64,8584355.493548388,1503028.14
4300,11,2500000,8621,8661,,40,65.64,1820371.57,1503028.14
4301,15,760000,8622,8654,,32,65.64,4522577.48037889,1503028.14
4302,12,2000000,8622,8675,,53,65.64,7658937.101338432,1503028.14
4303,11,1250208,8622,8670,,48,65.64,1820371.57,1503028.14
4304,11,850000,8625,8640,,15,65.64,1820371.57,1503028.14
4305,2,1100000,8625,8671,,46,65.64,2989003.2716499544,1503028.14
4306,5,800000,8625,8664,,39,65.64,1400922.5020242915,1503028.14
4307,2,1000000,8625,8695,,70,65.64,2989003.2716499544,1503028.14
4308,12,1000000,8625,8660,,35,65.64,7658937.101338432,1503028.14
4309,12,1000000,8626,8642,,16,65.64,7658937.101338432,1503028.14
4310,11,1000000,8626,8690,,64,65.64,1820371.57,1503028.14
4311,2,1000000,8626,8690,,64,65.64,2989003.2716499544,1503028.14
4312,13,750000,8626,8730,,104,65.64,7795654.71978022,1503028.14
4313,3,1500000,8626,8653,,27,65.64,9246769.549865229,1503028.14
4314,17,1092880,8627,8685,,58,65.64,1614143.0049603174,1503028.14
4315,9,700000,8627,8681,,54,65.64,3707403.8834951455,1503028.14
4316,3,2000000,8627,8646,,19,65.64,9246769.549865229,1503028.14
4317,20,1000000,8627,8713,,86,65.64,7597088.421768707,1503028.14
4318,20,1000000,8627,8713,,86,65.64,7597088.421768707,1503028.14
4319,4,1000000,8627,8654,,27,65.64,4297914.794871795,1503028.14
4320,22,1704320,8628,8753,,125,65.64,2904103.2512077293,1503028.14
4321,18,1000000,8629,8741,,112,65.64,8584355.493548388,1503028.14
4322,12,2000000,8629,8648,,19,65.64,7658937.101338432,1503028.14
4323,15,800000,8633,8656,,23,65.64,4522577.48037889,1503028.14
4324,16,650000,8633,8692,,59,65.64,2465023.1840707962,1503028.14
4325,16,650000,8633,8692,,59,65.64,2465023.1840707962,1503028.14
4326,11,1000000,8634,8702,,68,65.64,1820371.57,1503028.14
4327,11,1000000,8635,8689,,54,65.64,1820371.57,1503028.14
4328,16,1200000,8636,8667,,31,65.64,2465023.1840707962,1503028.14
4329,12,1000000,8636,8689,,53,65.64,7658937.101338432,1503028.14
4330,15,1000000,8636,8678,,42,65.64,4522577.48037889,1503028.14
4331,16,950000,8639,8657,,18,65.64,2465023.1840707962,1503028.14
4332,4,11000000,8640,8689,,49,65.64,4297914.794871795,1503028.14
4333,12,750000,8640,8694,,54,65.64,7658937.101338432,1503028.14
4334,16,900000,8640,8664,,24,65.64,2465023.1840707962,1503028.14
4335,17,1000000,8642,8842,,200,65.64,1614143.0049603174,1503028.14
4336,11,950000,8642,8660,,18,65.64,1820371.57,1503028.14
4337,24,550000,8646,8871,,225,65.64,23456062.532786883,1503028.14
4338,15,750000,8646,8684,,38,65.64,4522577.48037889,1503028.14
4339,12,600000,8646,8696,,50,65.64,7658937.101338432,1503028.14
4340,2,1100000,8646,8734,,88,65.64,2989003.2716499544,1503028.14
4341,11,2400000,8646,8725,,79,65.64,1820371.57,1503028.14
4342,18,2000000,8646,8649,,3,65.64,8584355.493548388,1503028.14
4343,17,750000,8647,8683,,36,65.64,1614143.0049603174,1503028.14
4344,23,700000,8647,8670,,23,65.64,5772926.70157068,1503028.14
4345,4,600000,8647,8692,,45,65.64,4297914.794871795,1503028.14
4346,13,600000,8647,8776,,129,65.64,7795654.71978022,1503028.14
4347,19,1500000,8647,8769,,122,65.64,6721340.5708154505,1503028.14
4348,11,1500000,8648,8720,,72,65.64,1820371.57,1503028.14
4349,5,700000,8648,8716,,68,65.64,1400922.5020242915,1503028.14
4350,15,750000,8648,8677,,29,65.64,4522577.48037889,1503028.14
4351,11,4400000,8648,8702,,54,65.64,1820371.57,1503028.14
4352,15,1400000,8648,8681,,33,65.64,4522577.48037889,1503028.14
4353,22,950000,8649,8688,,39,65.64,2904103.2512077293,1503028.14
4354,6,1000000,8649,8787,,138,65.64,1124713.2781954887,1503028.14
4355,12,2000000,8649,8664,,15,65.64,7658937.101338432,1503028.14
4356,15,650000,8649,8739,,90,65.64,4522577.48037889,1503028.14
4357,17,1500000,8650,8684,,34,65.64,1614143.0049603174,1503028.14
4358,2,2000000,8653,8698,,45,65.64,2989003.2716499544,1503028.14
4359,1,1000000,8653,8681,,28,65.64,3325419.7044334975,1503028.14
4360,15,800000,8653,8683,,30,65.64,4522577.48037889,1503028.14
4361,24,1500000,8653,8682,,29,65.64,23456062.532786883,1503028.14
4362,9,1000000,8654,8837,,183,65.64,3707403.8834951455,1503028.14
4363,13,1200000,8654,8675,,21,65.64,7795654.71978022,1503028.14
4364,11,2000000,8654,8716,,62,65.64,1820371.57,1503028.14
4365,11,1000000,8655,8689,,34,65.64,1820371.57,1503028.14
4366,11,1000000,8655,8717,,62,65.64,1820371.57,1503028.14
4367,17,2500000,8655,8811,,156,65.64,1614143.0049603174,1503028.14
4368,2,900000,8655,8751,,96,65.64,2989003.2716499544,1503028.14
4369,17,750000,8655,8837,,182,65.64,1614143.0049603174,1503028.14
4370,17,1400000,8655,8699,,44,65.64,1614143.0049603174,1503028.14
4371,16,2500000,8656,8702,,46,65.64,2465023.1840707962,1503028.14
4372,19,1000000,8656,8725,,69,65.64,6721340.5708154505,1503028.14
4373,2,1000000,8657,8695,,38,65.64,2989003.2716499544,1503028.14
4374,16,1800000,8657,8670,,13,65.64,2465023.1840707962,1503028.14
4375,15,780000,8657,8724,,67,65.64,4522577.48037889,1503028.14
4376,1,800000,8660,8702,,42,65.64,3325419.7044334975,1503028.14
4377,1,1000000,8660,8702,,42,65.64,3325419.7044334975,1503028.14
4378,2,1200000,8661,8716,,55,65.64,2989003.2716499544,1503028.14
4379,2,1200000,8661,8716,,55,65.64,2989003.2716499544,1503028.14
4380,4,700000,8662,8678,,16,65.64,4297914.794871795,1503028.14
4381,13,1200000,8662,8685,,23,65.64,7795654.71978022,1503028.14
4382,20,854000,8662,8752,,90,65.64,7597088.421768707,1503028.14
4383,2,900000,8663,8696,,33,65.64,2989003.2716499544,1503028.14
4384,14,525000,8667,8786,,119,65.64,5826416.914893617,1503028.14
4385,12,700000,8667,8915,,248,65.64,7658937.101338432,1503028.14
4386,8,800000,8668,8691,,23,65.64,1501617.2191780822,1503028.14
4387,16,1600000,8669,8719,,50,65.64,2465023.1840707962,1503028.14
4388,20,3600000,8670,8702,,32,65.64,7597088.421768707,1503028.14
4389,17,1400000,8670,8711,,41,65.64,1614143.0049603174,1503028.14
4390,12,1800000,8671,8706,,35,65.64,7658937.101338432,1503028.14
4391,2,1000000,8671,8822,,151,65.64,2989003.2716499544,1503028.14
4392,2,1000000,8671,8914,,243,65.64,2989003.2716499544,1503028.14
4393,11,1000000,8675,8731,,56,65.64,1820371.57,1503028.14
4394,16,2445000,8675,8781,,106,65.64,2465023.1840707962,1503028.14
4395,2,1000000,8675,8724,,49,65.64,2989003.2716499544,1503028.14
4396,18,600000,8676,8710,,34,65.64,8584355.493548388,1503028.14
4397,17,850000,8676,8719,,43,65.64,1614143.0049603174,1503028.14
4398,16,1500000,8676,8719,,43,65.64,2465023.1840707962,1503028.14
4399,2,1000000,8677,8741,,64,65.64,2989003.2716499544,1503028.14
4400,17,1000000,8677,8726,,49,65.64,1614143.0049603174,1503028.14
4401,1,900000,8677,8821,,144,65.64,3325419.7044334975,1503028.14
4402,17,1289150,8677,8751,,74,65.64,1614143.0049603174,1503028.14
4403,5,600000,8678,8720,,42,65.64,1400922.5020242915,1503028.14
4404,12,1000000,8678,8740,,62,65.64,7658937.101338432,1503028.14
4405,2,1250208,8678,8725,,47,65.64,2989003.2716499544,1503028.14
4406,17,1000000,8681,8738,,57,65.64,1614143.0049603174,1503028.14
4407,18,1000000,8681,8754,,73,65.64,8584355.493548388,1503028.14
4408,2,1600000,8681,8776,,95,65.64,2989003.2716499544,1503028.14
4409,21,1382000,8682,8690,,8,65.64,17091199.984,1503028.14
4410,12,1000000,8682,8732,,50,65.64,7658937.101338432,1503028.14
4411,7,600000,8682,8789,,107,65.64,3738553.685483871,1503028.14
4412,17,1500000,8683,8758,,75,65.64,1614143.0049603174,1503028.14
4413,2,1000000,8684,8703,,19,65.64,2989003.2716499544,1503028.14
4414,4,600000,8684,8741,,57,65.64,4297914.794871795,1503028.14
4415,23,1035300,8684,8758,,74,65.64,5772926.70157068,1503028.14
4416,2,1000000,8684,8716,,32,65.64,2989003.2716499544,1503028.14
4417,2,1000000,8684,8746,,62,65.64,2989003.2716499544,1503028.14
4418,11,1000000,8684,8758,,74,65.64,1820371.57,1503028.14
4419,1,600000,8684,8716,,32,65.64,3325419.7044334975,1503028.14
4420,6,1800000,8685,8751,,66,65.64,1124713.2781954887,1503028.14
4421,2,1000000,8685,8746,,61,65.64,2989003.2716499544,1503028.14
4422,13,1500000,8685,8718,,33,65.64,7795654.71978022,1503028.14
4423,17,1500000,8685,8731,,46,65.64,1614143.0049603174,1503028.14
4424,15,950000,8688,8751,,63,65.64,4522577.48037889,1503028.14
4425,15,750000,8689,8753,,64,65.64,4522577.48037889,1503028.14
4426,2,1000000,8689,8773,,84,65.64,2989003.2716499544,1503028.14
4427,15,750000,8690,8765,,75,65.64,4522577.48037889,1503028.14
4428,15,700000,8690,8837,,147,65.64,4522577.48037889,1503028.14
4429,17,1000000,8690,8723,,33,65.64,1614143.0049603174,1503028.14
4430,16,700000,8690,8752,,62,65.64,2465023.1840707962,1503028.14
4431,13,9600000,8691,8781,,90,65.64,7795654.71978022,1503028.14
4432,12,1000000,8691,8744,,53,65.64,7658937.101338432,1503028.14
4433,21,1500000,8691,8741,,50,65.64,17091199.984,1503028.14
4434,12,3500000,8692,8753,,61,65.64,7658937.101338432,1503028.14
4435,15,750000,8692,8859,,167,65.64,4522577.48037889,1503028.14
4436,11,1000000,8695,8712,,17,65.64,1820371.57,1503028.14
4437,10,1000000,8695,8822,,127,65.64,8282326.220930233,1503028.14
4438,13,950000,8696,8825,,129,65.64,7795654.71978022,1503028.14
4439,11,700000,8696,8710,,14,65.64,1820371.57,1503028.14
4440,5,1000000,8696,8786,,90,65.64,1400922.5020242915,1503028.14
4441,5,1000000,8696,8797,,101,65.64,1400922.5020242915,1503028.14
4442,3,3314105,8696,8727,,31,65.64,9246769.549865229,1503028.14
4443,15,700000,8697,8745,,48,65.64,4522577.48037889,1503028.14
4444,15,700000,8697,8752,,55,65.64,4522577.48037889,1503028.14
4445,5,1000000,8697,8769,,72,65.64,1400922.5020242915,1503028.14
4446,4,900000,8697,8740,,43,65.64,4297914.794871795,1503028.14
4447,12,570000,8697,8732,,35,65.64,7658937.101338432,1503028.14
4448,11,600000,8697,8803,,106,65.64,1820371.57,1503028.14
4449,4,900000,8698,8793,,95,65.64,4297914.794871795,1503028.14
4450,6,700000,8698,8780,,82,65.64,1124713.2781954887,1503028.14
4451,16,1200000,8698,8769,,71,65.64,2465023.1840707962,1503028.14
4452,13,750000,8699,8761,,62,65.64,7795654.71978022,1503028.14
4453,17,800000,8702,8832,,130,65.64,1614143.0049603174,1503028.14
4454,17,800000,8702,8912,,210,65.64,1614143.0049603174,1503028.14
4455,15,900000,8703,8912,,209,65.64,4522577.48037889,1503028.14
4456,6,520000,8703,8746,,43,65.64,1124713.2781954887,1503028.14
4457,23,600000,8703,8738,,35,65.64,5772926.70157068,1503028.14
4458,3,700000,8703,8761,,58,65.64,9246769.549865229,1503028.14
4459,16,1500000,8704,8745,,41,65.64,2465023.1840707962,1503028.14
4460,17,600000,8704,8719,,15,65.64,1614143.0049603174,1503028.14
4461,16,1100000,8704,8739,,35,65.64,2465023.1840707962,1503028.14
4462,17,600000,8705,8776,,71,65.64,1614143.0049603174,1503028.14
4463,11,3000000,8705,8751,,46,65.64,1820371.57,1503028.14
4464,1,1800000,8706,8724,,18,65.64,3325419.7044334975,1503028.14
4465,5,950000,8710,8740,,30,65.64,1400922.5020242915,1503028.14
4466,18,6529000,8711,8802,,91,65.64,8584355.493548388,1503028.14
4467,6,1500000,8711,8804,,93,65.64,1124713.2781954887,1503028.14
4468,24,8000000,8711,8765,,54,65.64,23456062.532786883,1503028.14
4469,17,1000000,8712,8755,,43,65.64,1614143.0049603174,1503028.14
4470,11,1000000,8712,8768,,56,65.64,1820371.57,1503028.14
4471,20,1500000,8712,8888,,176,65.64,7597088.421768707,1503028.14
4472,4,750000,8712,8816,,104,65.64,4297914.794871795,1503028.14
4473,2,800000,8712,8776,,64,65.64,2989003.2716499544,1503028.14
4474,15,2000000,8712,8867,,155,65.64,4522577.48037889,1503028.14
4475,15,2000000,8712,8913,,201,65.64,4522577.48037889,1503028.14
4476,13,750000,8713,8860,,147,65.64,7795654.71978022,1503028.14
4477,13,750000,8713,8846,,133,65.64,7795654.71978022,1503028.14
4478,17,1200000,8713,8727,,14,65.64,1614143.0049603174,1503028.14
4479,17,900000,8713,8796,,83,65.64,1614143.0049603174,1503028.14
4480,17,1000000,8713,8732,,19,65.64,1614143.0049603174,1503028.14
4481,17,750000,8713,8759,,46,65.64,1614143.0049603174,1503028.14
4482,15,1500000,8715,8754,,39,65.64,4522577.48037889,1503028.14
4483,16,850000,8716,8752,,36,65.64,2465023.1840707962,1503028.14
4484,1,1200000,8716,8751,,35,65.64,3325419.7044334975,1503028.14
4485,11,10000000,8716,8845,,129,65.64,1820371.57,1503028.14
4486,17,1000000,8717,8765,,48,65.64,1614143.0049603174,1503028.14
4487,11,2500000,8718,8796,,78,65.64,1820371.57,1503028.14
4488,17,800000,8718,8902,,184,65.64,1614143.0049603174,1503028.14
4489,11,12000000,8718,8817,,99,65.64,1820371.57,1503028.14
4490,16,1500000,8718,8915,,197,65.64,2465023.1840707962,1503028.14
4491,1,925000,8719,8800,,81,65.64,3325419.7044334975,1503028.14
4492,12,2000000,8720,8796,,76,65.64,7658937.101338432,1503028.14
4493,1,800000,8720,8738,,18,65.64,3325419.7044334975,1503028.14
4494,16,1300000,8721,8744,,23,65.64,2465023.1840707962,1503028.14
4495,23,1250000,8723,8884,,161,65.64,5772926.70157068,1503028.14
4496,17,520000,8723,8726,,3,65.64,1614143.0049603174,1503028.14
4497,17,800000,8724,8747,,23,65.64,1614143.0049603174,1503028.14
4498,17,2000000,8725,8760,,35,65.64,1614143.0049603174,1503028.14
4499,19,750000,8725,8780,,55,65.64,6721340.5708154505,1503028.14
4500,18,1400000,8725,8758,,33,65.64,8584355.493548388,1503028.14
4501,17,700000,8727,8796,,69,65.64,1614143.0049603174,1503028.14
4502,6,927000,8727,8823,,96,65.64,1124713.2781954887,1503028.14
4503,15,700000,8727,8859,,132,65.64,4522577.48037889,1503028.14
4504,15,1000000,8730,8783,,53,65.64,4522577.48037889,1503028.14
4505,11,750000,8730,8751,,21,65.64,1820371.57,1503028.14
4506,4,3000000,8730,8802,,72,65.64,4297914.794871795,1503028.14
4507,19,5000000,8730,8762,,32,65.64,6721340.5708154505,1503028.14
4508,23,850000,8730,8803,,73,65.64,5772926.70157068,1503028.14
4509,6,1000000,8731,8790,,59,65.64,1124713.2781954887,1503028.14
4510,18,1200000,8731,8776,,45,65.64,8584355.493548388,1503028.14
4511,5,750000,8731,8836,,105,65.64,1400922.5020242915,1503028.14
4512,11,11000000,8732,8886,,154,65.64,1820371.57,1503028.14
4513,18,1000000,8732,8824,,92,65.64,8584355.493548388,1503028.14
4514,17,700000,8732,8773,,41,65.64,1614143.0049603174,1503028.14
4515,15,1000000,8733,8787,,54,65.64,4522577.48037889,1503028.14
4516,12,700000,8733,8768,,35,65.64,7658937.101338432,1503028.14
4517,15,750000,8733,8767,,34,65.64,4522577.48037889,1503028.14
4518,11,5000000,8733,8901,,168,65.64,1820371.57,1503028.14
4519,1,750000,8734,8801,,67,65.64,3325419.7044334975,1503028.14
4520,19,800000,8734,8808,,74,65.64,6721340.5708154505,1503028.14
4521,11,1198000,8738,8795,,57,65.64,1820371.57,1503028.14
4522,2,1500000,8738,8780,,42,65.64,2989003.2716499544,1503028.14
4523,16,600000,8740,8802,,62,65.64,2465023.1840707962,1503028.14
4524,4,1000000,8740,8781,,41,65.64,4297914.794871795,1503028.14
4525,2,800000,8740,8895,,155,65.64,2989003.2716499544,1503028.14
4526,15,1000000,8740,8789,,49,65.64,4522577.48037889,1503028.14
4527,24,580000,8741,8817,,76,65.64,23456062.532786883,1503028.14
4528,19,1600000,8741,8768,,27,65.64,6721340.5708154505,1503028.14
4529,11,3000000,8741,8835,,94,65.64,1820371.57,1503028.14
4530,17,1000000,8741,8795,,54,65.64,1614143.0049603174,1503028.14
4531,17,600000,8745,8801,,56,65.64,1614143.0049603174,1503028.14
4532,16,950000,8745,8800,,55,65.64,2465023.1840707962,1503028.14
4533,17,750000,8745,8838,,93,65.64,1614143.0049603174,1503028.14
4534,2,600000,8747,8891,,144,65.64,2989003.2716499544,1503028.14
4535,2,1300000,8748,8891,,143,65.64,2989003.2716499544,1503028.14
4536,22,750000,8748,8788,,40,65.64,2904103.2512077293,1503028.14
4537,2,1000000,8748,8835,,87,65.64,2989003.2716499544,1503028.14
4538,17,1200000,8751,8846,,95,65.64,1614143.0049603174,1503028.14
4539,17,1200000,8751,8779,,28,65.64,1614143.0049603174,1503028.14
4540,17,850000,8751,8801,,50,65.64,1614143.0049603174,1503028.14
4541,11,1000000,8751,8780,,29,65.64,1820371.57,1503028.14
4542,4,1000000,8751,8919,,168,65.64,4297914.794871795,1503028.14
4543,17,600000,8751,8775,,24,65.64,1614143.0049603174,1503028.14
4544,16,600000,8752,8894,,142,65.64,2465023.1840707962,1503028.14
4545,17,1000000,8753,8783,,30,65.64,1614143.0049603174,1503028.14
4546,17,700000,8753,8811,,58,65.64,1614143.0049603174,1503028.14
4547,2,650000,8753,8810,,57,65.64,2989003.2716499544,1503028.14
4548,17,600000,8754,8781,,27,65.64,1614143.0049603174,1503028.14
4549,11,1175000,8754,8795,,41,65.64,1820371.57,1503028.14
4550,10,900000,8754,8866,,112,65.64,8282326.220930233,1503028.14
4551,15,550000,8758,8858,,100,65.64,4522577.48037889,1503028.14
4552,12,3000000,8758,8828,,70,65.64,7658937.101338432,1503028.14
4553,11,1000000,8758,8835,,77,65.64,1820371.57,1503028.14
4554,12,2000000,8758,8874,,116,65.64,7658937.101338432,1503028.14
4555,15,1350000,8759,8766,,7,65.64,4522577.48037889,1503028.14
4556,18,1100000,8759,8788,,29,65.64,8584355.493548388,1503028.14
4557,4,1200000,8760,8811,,51,65.64,4297914.794871795,1503028.14
4558,6,1000000,8760,8780,,20,65.64,1124713.2781954887,1503028.14
4559,17,1193375,8761,8884,,123,65.64,1614143.0049603174,1503028.14
4560,5,820000,8762,8919,,157,65.64,1400922.5020242915,1503028.14
4561,2,1200000,8762,8824,,62,65.64,2989003.2716499544,1503028.14
4562,16,1400000,8764,8817,,53,65.64,2465023.1840707962,1503028.14
4563,16,2500000,8765,8823,,58,65.64,2465023.1840707962,1503028.14
4564,18,1000000,8765,8808,,43,65.64,8584355.493548388,1503028.14
4565,11,1000000,8767,8803,,36,65.64,1820371.57,1503028.14
4566,12,700000,8769,8818,,49,65.64,7658937.101338432,1503028.14
4567,12,1000000,8769,8802,,33,65.64,7658937.101338432,1503028.14
4568,7,779600,8769,8825,,56,65.64,3738553.685483871,1503028.14
4569,12,950000,8769,8801,,32,65.64,7658937.101338432,1503028.14
4570,17,1000000,8773,8816,,43,65.64,1614143.0049603174,1503028.14
4571,2,900000,8773,8817,,44,65.64,2989003.2716499544,1503028.14
4572,3,2000000,8773,8814,,41,65.64,9246769.549865229,1503028.14
4573,11,2500000,8773,8898,,125,65.64,1820371.57,1503028.14
4574,15,800000,8773,8828,,55,65.64,4522577.48037889,1503028.14
4575,1,1000000,8774,8804,,30,65.64,3325419.7044334975,1503028.14
4576,21,600000,8774,8794,,20,65.64,17091199.984,1503028.14
4577,2,700000,8774,8804,,30,65.64,2989003.2716499544,1503028.14
4578,17,1500000,8774,8836,,62,65.64,1614143.0049603174,1503028.14
4579,21,600000,8774,8781,,7,65.64,17091199.984,1503028.14
4580,11,1500000,8774,8823,,49,65.64,1820371.57,1503028.14
4581,8,565000,8774,8780,,6,65.64,1501617.2191780822,1503028.14
4582,24,1000000,8775,8807,,32,65.64,23456062.532786883,1503028.14
4583,24,900000,8776,8823,,47,65.64,23456062.532786883,1503028.14
4584,2,1100000,8779,8830,,51,65.64,2989003.2716499544,1503028.14
4585,17,1000000,8780,8816,,36,65.64,1614143.0049603174,1503028.14
4586,17,950000,8780,8824,,44,65.64,1614143.0049603174,1503028.14
4587,1,1000000,8780,8844,,64,65.64,3325419.7044334975,1503028.14
4588,2,1000000,8780,8844,,64,65.64,2989003.2716499544,1503028.14
4589,12,700000,8780,8838,,58,65.64,7658937.101338432,1503028.14
4590,12,700000,8780,8838,,58,65.64,7658937.101338432,1503028.14
4591,2,1000000,8781,8853,,72,65.64,2989003.2716499544,1503028.14
4592,16,1000000,8781,8803,,22,65.64,2465023.1840707962,1503028.14
4593,1,1000000,8782,8815,,33,65.64,3325419.7044334975,1503028.14
4594,20,1800000,8783,8877,,94,65.64,7597088.421768707,1503028.14
4595,19,1200000,8786,8844,,58,65.64,6721340.5708154505,1503028.14
4596,7,1000000,8786,8902,,116,65.64,3738553.685483871,1503028.14
4597,12,1000000,8787,8871,,84,65.64,7658937.101338432,1503028.14
4598,3,1400000,8787,8824,,37,65.64,9246769.549865229,1503028.14
4599,24,800000,8787,8815,,28,65.64,23456062.532786883,1503028.14
4600,17,1000000,8788,8803,,15,65.64,1614143.0049603174,1503028.14
4601,4,550000,8788,8906,,118,65.64,4297914.794871795,1503028.14
4602,4,1500000,8789,8835,,46,65.64,4297914.794871795,1503028.14
4603,11,2350000,8789,8872,,83,65.64,1820371.57,1503028.14
4604,5,1500000,8789,8835,,46,65.64,1400922.5020242915,1503028.14
4605,17,1000000,8793,8821,,28,65.64,1614143.0049603174,1503028.14
4606,15,700000,8793,8817,,24,65.64,4522577.48037889,1503028.14
4607,2,800000,8793,8919,,126,65.64,2989003.2716499544,1503028.14
4608,11,800000,8794,8832,,38,65.64,1820371.57,1503028.14
4609,5,650000,8794,8838,,44,65.64,1400922.5020242915,1503028.14
4610,5,650000,8794,8843,,49,65.64,1400922.5020242915,1503028.14
4611,5,1000000,8795,8901,,106,65.64,1400922.5020242915,1503028.14
4612,19,900000,8796,8844,,48,65.64,6721340.5708154505,1503028.14
4613,12,2000000,8796,8824,,28,65.64,7658937.101338432,1503028.14
4614,11,1000000,8796,8846,,50,65.64,1820371.57,1503028.14
4615,17,750000,8796,8858,,62,65.64,1614143.0049603174,1503028.14
4616,17,3000000,8797,8863,,66,65.64,1614143.0049603174,1503028.14
4617,17,1000000,8801,8913,,112,65.64,1614143.0049603174,1503028.14
4618,11,2000000,8802,8877,,75,65.64,1820371.57,1503028.14
4619,22,1990000,8802,8916,,114,65.64,2904103.2512077293,1503028.14
4620,15,1000000,8802,8831,,29,65.64,4522577.48037889,1503028.14
4621,2,600000,8802,8822,,20,65.64,2989003.2716499544,1503028.14
4622,17,900000,8802,8823,,21,65.64,1614143.0049603174,1503028.14
4623,7,975000,8804,8814,,10,65.64,3738553.685483871,1503028.14
4624,22,860000,8804,8828,,24,65.64,2904103.2512077293,1503028.14
4625,17,1300000,8807,8842,,35,65.64,1614143.0049603174,1503028.14
4626,2,1200000,8808,8829,,21,65.64,2989003.2716499544,1503028.14
4627,19,1000000,8810,8837,,27,65.64,6721340.5708154505,1503028.14
4628,11,2200000,8810,8832,,22,65.64,1820371.57,1503028.14
4629,2,1000000,8811,8829,,18,65.64,2989003.2716499544,1503028.14
4630,11,1000000,8811,8916,,105,65.64,1820371.57,1503028.14
4631,2,800000,8811,8909,,98,65.64,2989003.2716499544,1503028.14
4632,11,2500000,8814,8864,,50,65.64,1820371.57,1503028.14
4633,12,1200000,8815,8829,,14,65.64,7658937.101338432,1503028.14
4634,12,3000000,8815,8863,,48,65.64,7658937.101338432,1503028.14
4635,19,800000,8815,8857,,42,65.64,6721340.5708154505,1503028.14
4636,19,800000,8815,8846,,31,65.64,6721340.5708154505,1503028.14
4637,18,1000000,8816,8863,,47,65.64,8584355.493548388,1503028.14
4638,11,900000,8816,8858,,42,65.64,1820371.57,1503028.14
4639,15,1500000,8821,8858,,37,65.64,4522577.48037889,1503028.14
4640,3,3000000,8821,8894,,73,65.64,9246769.549865229,1503028.14
4641,13,1000000,8822,8871,,49,65.64,7795654.71978022,1503028.14
4642,11,1200000,8822,8860,,38,65.64,1820371.57,1503028.14
4643,2,700000,8823,8907,,84,65.64,2989003.2716499544,1503028.14
4644,11,1200000,8824,8864,,40,65.64,1820371.57,1503028.14
4645,18,900000,8825,8881,,56,65.64,8584355.493548388,1503028.14
4646,11,15000000,8825,8914,,89,65.64,1820371.57,1503028.14
4647,17,1300000,8829,8906,,77,65.64,1614143.0049603174,1503028.14
4648,2,1500000,8831,8881,,50,65.64,2989003.2716499544,1503028.14
4649,0,1500000,8832,8892,,60,65.64,8418173.322222222,1503028.14
4650,12,3000000,8836,8870,,34,65.64,7658937.101338432,1503028.14
4651,11,1000000,8836,8874,,38,65.64,1820371.57,1503028.14
4652,16,750000,8837,8853,,16,65.64,2465023.1840707962,1503028.14
4653,12,2500000,8838,8871,,33,65.64,7658937.101338432,1503028.14
4654,11,600000,8839,8878,,39,65.64,1820371.57,1503028.14
4655,15,700000,8839,8906,,67,65.64,4522577.48037889,1503028.14
4656,12,700000,8839,8893,,54,65.64,7658937.101338432,1503028.14
4657,11,1500000,8840,8893,,53,65.64,1820371.57,1503028.14
4658,11,1100000,8842,8893,,51,65.64,1820371.57,1503028.14
4659,24,4000000,8842,8874,,32,65.64,23456062.532786883,1503028.14
4660,17,1300000,8843,8878,,35,65.64,1614143.0049603174,1503028.14
4661,17,800000,8843,8898,,55,65.64,1614143.0049603174,1503028.14
4662,13,750000,8844,8846,,2,65.64,7795654.71978022,1503028.14
4663,5,1000000,8858,8873,,15,29.02,1400922.5020242915,3613519.51
4664,12,3500000,8860,8901,,41,29.02,7658937.101338432,3613519.51
4665,24,1500000,8860,8891,,31,29.02,23456062.532786883,3613519.51
4666,13,2000000,8860,8916,,56,29.02,7795654.71978022,3613519.51
4667,24,2000000,8860,8891,,31,29.02,23456062.532786883,3613519.51
4668,20,750000,8860,8900,,40,29.02,7597088.421768707,3613519.51
4669,1,1000000,8863,8908,,45,29.02,3325419.7044334975,3613519.51
4670,2,1000000,8864,8895,,31,29.02,2989003.2716499544,3613519.51
4671,11,2500000,8866,8899,,33,29.02,1820371.57,3613519.51
4672,15,700000,8870,8907,,37,29.02,4522577.48037889,3613519.51
4673,17,950000,8870,8899,,29,29.02,1614143.0049603174,3613519.51
4674,4,900000,8873,8913,,40,29.02,4297914.794871795,3613519.51
4675,5,1000000,8874,8916,,42,29.02,1400922.5020242915,3613519.51
4676,1,650000,8877,8914,,37,29.02,3325419.7044334975,3613519.51
4677,1,1000000,8878,8919,,41,29.02,3325419.7044334975,3613519.51
4678,11,1700000,8880,8913,,33,29.02,1820371.57,3613519.51
4679,5,1000000,8881,8913,,32,29.02,1400922.5020242915,3613519.51
4680,17,1000000,8881,8919,,38,29.02,1614143.0049603174,3613519.51
4681,11,800000,8884,8899,,15,29.02,1820371.57,3613519.51
4682,1,1000000,8885,8916,,31,29.02,3325419.7044334975,3613519.51
4683,16,1500000,8885,8902,,17,29.02,2465023.1840707962,3613519.51
4684,15,800000,8886,8907,,21,29.02,4522577.48037889,3613519.51
4685,16,1150000,8887,8913,,26,29.02,2465023.1840707962,3613519.51
4686,2,1200000,8891,8916,,25,29.02,2989003.2716499544,3613519.51
4687,12,800000,8893,8922,,29,29.02,7658937.101338432,3613519.51
4688,21,100000000,8894,8916,,22,29.02,17091199.984,3613519.51
4689,14,600000,8895,8921,,26,29.02,5826416.914893617,3613519.51
4690,24,850000,8906,8921,,15,29.02,23456062.532786883,3613519.51
4691,15,19870555,4,404,,400,179.4,4522577.48037889,8579311.0
4692,2,20000000,25,248,,223,179.4,2989003.2716499544,8579311.0
4693,3,800000,141,199,6630,58,184.47,9246769.549865229,9047699.97
4694,11,719000,317,626,6491,309,184.47,1820371.57,9047699.97
4695,11,1000000,645,661,8412,16,202.94,1820371.57,7117555.88
4696,17,1500000,1221,1410,7621,189,219.0,1614143.0049603174,7652071.6
4697,7,7000000,1384,2140,6662,756,219.0,3738553.685483871,7652071.6
4698,17,700000,1479,1537,6694,58,219.0,1614143.0049603174,7652071.6
4699,13,9000000,1647,2273,6794,626,423.81,7795654.71978022,11229609.36
4700,2,49524000,1668,3510,6739,1842,423.81,2989003.2716499544,11229609.36
4701,19,511360,1677,1958,6513,281,423.81,6721340.5708154505,11229609.36
4702,13,17000000,1907,2474,6723,567,423.81,7795654.71978022,11229609.36
4703,11,800000,1962,2017,8264,55,166.1,1820371.57,3498084.51
4704,22,40000000,2028,2545,7885,517,166.1,2904103.2512077293,3498084.51
4705,11,750000,2052,2123,6973,71,166.1,1820371.57,3498084.51
4706,17,520000,2203,2241,7313,38,166.1,1614143.0049603174,3498084.51
4707,11,793000,2203,2269,8018,66,166.1,1820371.57,3498084.51
4708,12,36000000,2592,3000,6508,408,230.03,7658937.101338432,14812242.86
4709,13,7500000,2637,3348,6571,711,230.03,7795654.71978022,14812242.86
4710,24,15000000,2668,3497,7248,829,417.96,23456062.532786883,14954908.92
4711,17,650000,2735,2775,7653,40,417.96,1614143.0049603174,14954908.92
4712,23,17935000,2784,2999,7325,215,417.96,5772926.70157068,14954908.92
4713,11,700000,2860,3176,8542,316,417.96,1820371.57,14954908.92
4714,11,850000,2928,2956,7414,28,417.96,1820371.57,14954908.92
4715,21,38864000,2998,5339,6589,2341,417.96,17091199.984,14954908.92
4716,2,46000000,3109,3734,8557,625,281.46,2989003.2716499544,11503993.02
4717,1,42800000,3117,3370,7305,253,281.46,3325419.7044334975,11503993.02
4718,16,700000,3125,3141,8643,16,281.46,2465023.1840707962,11503993.02
4719,17,1600000,3155,3180,8739,25,281.46,1614143.0049603174,11503993.02
4720,6,502000,3158,3547,6680,389,281.46,1124713.2781954887,11503993.02
4721,17,620135,3167,3190,8219,23,281.46,1614143.0049603174,11503993.02
4722,3,38000000,3176,4331,8524,1155,281.46,9246769.549865229,11503993.02
4723,11,544700,3193,3217,6354,24,281.46,1820371.57,11503993.02
4724,11,650000,3215,3307,7688,92,281.46,1820371.57,11503993.02
4725,2,700000,3239,3271,7612,32,281.46,2989003.2716499544,11503993.02
4726,16,1000000,3251,3273,6862,22,281.46,2465023.1840707962,11503993.02
4727,3,800000,3288,3622,6826,334,281.46,9246769.549865229,11503993.02
4728,12,750000,3291,3326,6416,35,281.46,7658937.101338432,11503993.02
4729,2,1500000,3300,4509,7334,1209,281.46,2989003.2716499544,11503993.02
4730,11,670000,3502,3512,6366,10,205.39,1820371.57,9006193.27
4731,16,1000000,3519,3610,7374,91,205.39,2465023.1840707962,9006193.27
4732,17,750000,3603,3616,6683,13,205.39,1614143.0049603174,9006193.27
4733,13,800000,3622,3903,8384,281,205.39,7795654.71978022,9006193.27
4734,15,900000,3665,3705,8010,40,205.39,4522577.48037889,9006193.27
4735,3,800000,3673,3699,7772,26,205.39,9246769.549865229,9006193.27
4736,11,912050,3673,3812,7561,139,205.39,1820371.57,9006193.27
4737,17,612624,3694,3707,7289,13,205.39,1614143.0049603174,9006193.27
4738,11,700000,3700,3722,6393,22,205.39,1820371.57,9006193.27
4739,12,2500000,3729,3798,7093,69,205.39,7658937.101338432,9006193.27
4740,10,33520000,3792,4093,7079,301,312.72,8282326.220930233,13350024.59
4741,12,29171800,3798,5316,7869,1518,312.72,7658937.101338432,13350024.59
4742,2,600000,3823,3852,8922,29,312.72,2989003.2716499544,13350024.59
4743,16,600000,3823,3852,7886,29,312.72,2465023.1840707962,13350024.59
4744,0,560000,3852,3993,6455,141,312.72,8418173.322222222,13350024.59
4745,17,800000,3852,3882,7134,30,312.72,1614143.0049603174,13350024.59
4746,21,3000000,3922,4275,8746,353,312.72,17091199.984,13350024.59
4747,17,700000,3936,3986,6966,50,312.72,1614143.0049603174,13350024.59
4748,11,750000,3937,4069,7012,132,312.72,1820371.57,13350024.59
4749,24,750000,3951,3960,6865,9,312.72,23456062.532786883,13350024.59
4750,7,20000000,3958,4358,7963,400,312.72,3738553.685483871,13350024.59
4751,19,723000,3978,4194,7780,216,312.72,6721340.5708154505,13350024.59
4752,2,608848,3994,4225,8732,231,312.72,2989003.2716499544,13350024.59
4753,17,850000,4006,4128,7226,122,312.72,1614143.0049603174,13350024.59
4754,2,650000,4047,4077,6801,30,312.72,2989003.2716499544,13350024.59
4755,3,800000,4056,4232,8067,176,312.72,9246769.549865229,13350024.59
4756,7,716861,4058,4369,7963,311,312.72,3738553.685483871,13350024.59
4757,24,5000000,4062,6198,8223,2136,312.72,23456062.532786883,13350024.59
4758,24,800000,4093,4131,7299,38,312.72,23456062.532786883,13350024.59
4759,24,36000000,4093,5192,6844,1099,312.72,23456062.532786883,13350024.59
4760,7,750000,4124,4147,8467,23,248.15,3738553.685483871,12693718.64
4761,2,780000,4173,4236,6570,63,248.15,2989003.2716499544,12693718.64
4762,16,600000,4173,4258,7162,85,248.15,2465023.1840707962,12693718.64
4763,17,708390,5567,5639,6414,72,246.12,1614143.0049603174,6701891.81
4764,17,708390,5567,5639,6494,72,246.12,1614143.0049603174,6701891.81
4765,17,680000,4204,4238,7932,34,248.15,1614143.0049603174,12693718.64
4766,11,800000,4272,4421,8703,149,248.15,1820371.57,12693718.64
4767,2,687000,4287,4378,7299,91,248.15,2989003.2716499544,12693718.64
4768,0,4000000,4288,4327,7358,39,248.15,8418173.322222222,12693718.64
4769,2,550000,4303,4434,7358,131,248.15,2989003.2716499544,12693718.64
4770,17,501480,4317,4357,7522,40,248.15,1614143.0049603174,12693718.64
4771,11,1130000,4322,4797,6639,475,248.15,1820371.57,12693718.64
4772,2,600000,4323,4337,8146,14,248.15,2989003.2716499544,12693718.64
4773,1,700000,4349,4376,8513,27,248.15,3325419.7044334975,12693718.64
4774,23,17000000,4357,4764,8340,407,248.15,5772926.70157068,12693718.64
4775,12,1000000,4385,4407,6959,22,248.15,7658937.101338432,12693718.64
4776,11,637920,4387,4517,6331,130,248.15,1820371.57,12693718.64
4777,18,900000,4398,4434,8801,36,248.15,8584355.493548388,12693718.64
4778,2,600000,4398,4456,7698,58,248.15,2989003.2716499544,12693718.64
4779,21,25000000,4398,4860,6366,462,248.15,17091199.984,12693718.64
4780,17,530000,4408,4461,6770,53,248.15,1614143.0049603174,12693718.64
4781,17,650000,4426,4495,7299,69,248.15,1614143.0049603174,12693718.64
4782,12,75000000,4443,5281,7709,838,248.15,7658937.101338432,12693718.64
4783,3,700000,4447,4925,7460,478,248.15,9246769.549865229,12693718.64
4784,12,45000000,4457,5248,7667,791,248.15,7658937.101338432,12693718.64
4785,3,2236000,4462,4863,6625,401,248.15,9246769.549865229,12693718.64
4786,15,8250000,4464,5358,6547,894,248.15,4522577.48037889,12693718.64
4787,21,75000000,4464,5548,6414,1084,248.15,17091199.984,12693718.64
4788,16,1000000,4464,4594,6966,130,248.15,2465023.1840707962,12693718.64
4789,2,750000,4482,5015,6834,533,258.28,2989003.2716499544,7314077.5
4790,16,550000,4492,4611,6438,119,258.28,2465023.1840707962,7314077.5
4791,12,30000000,4496,8004,8053,3508,258.28,7658937.101338432,7314077.5
4792,2,600000,4498,4601,7709,103,258.28,2989003.2716499544,7314077.5
4793,24,130000000,4503,5168,7052,665,258.28,23456062.532786883,7314077.5
4794,2,532000,4504,4589,7780,85,258.28,2989003.2716499544,7314077.5
4795,11,520000,4510,4561,8643,51,258.28,1820371.57,7314077.5
4796,21,30000000,4520,5727,6522,1207,258.28,17091199.984,7314077.5
4797,12,2250000,4534,4645,8832,111,258.28,7658937.101338432,7314077.5
4798,11,1000000,4540,4589,6989,49,258.28,1820371.57,7314077.5
4799,2,800000,4551,4625,6632,74,258.28,2989003.2716499544,7314077.5
4800,17,1000000,4555,4608,7033,53,258.28,1614143.0049603174,7314077.5
4801,2,570000,4555,4631,7575,76,258.28,2989003.2716499544,7314077.5
4802,16,750000,4587,4639,6520,52,258.28,2465023.1840707962,7314077.5
4803,11,1000000,4588,4965,8082,377,258.28,1820371.57,7314077.5
4804,2,600000,4594,4730,8104,136,258.28,2989003.2716499544,7314077.5
4805,19,1000000,4601,4688,6400,87,258.28,6721340.5708154505,7314077.5
4806,24,600000,4603,4644,8388,41,258.28,23456062.532786883,7314077.5
4807,17,630000,4621,4688,8101,67,258.28,1614143.0049603174,7314077.5
4808,2,600000,4625,4828,6934,203,258.28,2989003.2716499544,7314077.5
4809,3,28000000,4625,5232,6875,607,258.28,9246769.549865229,7314077.5
4810,11,1000000,4638,4671,6427,33,258.28,1820371.57,7314077.5
4811,17,625000,4646,4685,7885,39,258.28,1614143.0049603174,7314077.5
4812,17,630000,4649,4705,7943,56,258.28,1614143.0049603174,7314077.5
4813,16,650000,4650,4713,8220,63,258.28,2465023.1840707962,7314077.5
4814,2,641063,4652,4726,6487,74,258.28,2989003.2716499544,7314077.5
4815,1,600000,4670,4762,8060,92,258.28,3325419.7044334975,7314077.5
4816,17,600000,4671,4702,6478,31,258.28,1614143.0049603174,7314077.5
4817,17,700000,4686,4726,7695,40,258.28,1614143.0049603174,7314077.5
4818,17,510000,4686,4812,7085,126,258.28,1614143.0049603174,7314077.5
4819,19,600000,4687,4869,8626,182,258.28,6721340.5708154505,7314077.5
4820,11,1569796,4688,4758,6553,70,258.28,1820371.57,7314077.5
4821,2,700000,4698,5171,7605,473,258.28,2989003.2716499544,7314077.5
4822,16,1500000,4701,4730,6801,29,258.28,2465023.1840707962,7314077.5
4823,1,559428,4707,4792,7893,85,258.28,3325419.7044334975,7314077.5
4824,12,600000,4708,4750,8151,42,258.28,7658937.101338432,7314077.5
4825,11,600000,4722,4798,7561,76,258.28,1820371.57,7314077.5
4826,4,600000,4723,4814,8256,91,258.28,4297914.794871795,7314077.5
4827,13,1200000,4729,5483,8745,754,258.28,7795654.71978022,7314077.5
4828,15,800000,4751,4821,6540,70,258.28,4522577.48037889,7314077.5
4829,11,526780,4761,4825,7948,64,258.28,1820371.57,7314077.5
4830,17,562376,4762,4804,7600,42,258.28,1614143.0049603174,7314077.5
4831,11,1500000,4779,4810,6526,31,258.28,1820371.57,7314077.5
4832,24,33000000,4782,4939,8562,157,258.28,23456062.532786883,7314077.5
4833,17,850000,4785,4796,8751,11,258.28,1614143.0049603174,7314077.5
4834,18,550000,4786,4821,7932,35,258.28,8584355.493548388,7314077.5
4835,24,5000000,4791,4820,8720,29,258.28,23456062.532786883,7314077.5
4836,18,630000,4793,4856,8761,63,258.28,8584355.493548388,7314077.5
4837,21,800000,4811,4896,6569,85,258.28,17091199.984,7314077.5
4838,2,635200,4814,5049,7926,235,258.28,2989003.2716499544,7314077.5
4839,2,664480,4825,4853,6422,28,258.28,2989003.2716499544,7314077.5
4840,23,750000,4835,6722,6751,1887,258.28,5772926.70157068,7314077.5
4841,15,700000,4859,4924,6982,65,253.83,4522577.48037889,6984378.81
4842,2,840000,4866,4890,7305,24,253.83,2989003.2716499544,6984378.81
4843,11,783972,4874,4890,6486,16,253.83,1820371.57,6984378.81
4844,2,515040,4882,5010,7796,128,253.83,2989003.2716499544,6984378.81
4845,1,650000,4890,5076,6422,186,253.83,3325419.7044334975,6984378.81
4846,2,650000,4891,4996,7570,105,253.83,2989003.2716499544,6984378.81
4847,17,600000,4897,5108,6308,211,253.83,1614143.0049603174,6984378.81
4848,17,600000,4897,5108,6308,211,253.83,1614143.0049603174,6984378.81
4849,11,4000000,4908,5031,6358,123,253.83,1820371.57,6984378.81
4850,20,575000,4910,4931,6316,21,253.83,7597088.421768707,6984378.81
4851,24,81000000,4915,6198,8223,1283,253.83,23456062.532786883,6984378.81
4852,17,700000,4919,4966,6798,47,253.83,1614143.0049603174,6984378.81
4853,9,700000,4925,5097,6396,172,253.83,3707403.8834951455,6984378.81
4854,15,600000,4930,5017,7970,87,253.83,4522577.48037889,6984378.81
4855,17,650000,4943,5007,6484,64,253.83,1614143.0049603174,6984378.81
4856,17,1500000,4946,5049,6605,103,253.83,1614143.0049603174,6984378.81
4857,17,875000,4950,5016,6840,66,253.83,1614143.0049603174,6984378.81
4858,19,600000,4953,4987,8003,34,253.83,6721340.5708154505,6984378.81
4859,11,879840,4964,5062,6339,98,253.83,1820371.57,6984378.81
4860,16,1650000,4971,5356,7359,385,253.83,2465023.1840707962,6984378.81
4861,16,1650000,4971,5352,7359,381,253.83,2465023.1840707962,6984378.81
4862,16,1500000,4971,5352,7359,381,253.83,2465023.1840707962,6984378.81
4863,16,2840000,4971,5352,7359,381,253.83,2465023.1840707962,6984378.81
4864,16,2940000,4971,5352,7359,381,253.83,2465023.1840707962,6984378.81
4865,16,2810000,4971,5352,7359,381,253.83,2465023.1840707962,6984378.81
4866,16,2840000,4971,5352,7359,381,253.83,2465023.1840707962,6984378.81
4867,15,90980100,4973,6081,7066,1108,253.83,4522577.48037889,6984378.81
4868,12,1200000,4981,5099,6629,118,253.83,7658937.101338432,6984378.81
4869,12,100000000,4981,6676,7248,1695,253.83,7658937.101338432,6984378.81
4870,9,5000000,4986,5323,7057,337,253.83,3707403.8834951455,6984378.81
4871,9,3355200,4986,5323,7057,337,253.83,3707403.8834951455,6984378.81
4872,2,575000,4986,5001,8836,15,253.83,2989003.2716499544,6984378.81
4873,15,94000000,4992,5860,7809,868,253.83,4522577.48037889,6984378.81
4874,17,1000000,4996,5015,8031,19,253.83,1614143.0049603174,6984378.81
4875,12,650000,5007,5066,6555,59,253.83,7658937.101338432,6984378.81
4876,12,650000,5007,5066,6555,59,253.83,7658937.101338432,6984378.81
4877,3,35000000,5008,5679,6700,671,253.83,9246769.549865229,6984378.81
4878,5,1200000,5015,5525,7421,510,253.83,1400922.5020242915,6984378.81
4879,2,700000,5017,5071,7318,54,253.83,2989003.2716499544,6984378.81
4880,21,50000000,5021,7173,7589,2152,253.83,17091199.984,6984378.81
4881,2,520000,5027,5479,6438,452,253.83,2989003.2716499544,6984378.81
4882,11,1115088,5028,5064,6470,36,253.83,1820371.57,6984378.81
4883,1,614000,5036,5132,6899,96,253.83,3325419.7044334975,6984378.81
4884,24,55000000,5038,5575,6318,537,253.83,23456062.532786883,6984378.81
4885,17,700000,5042,5105,8072,63,253.83,1614143.0049603174,6984378.81
4886,18,640000,5043,5073,7341,30,253.83,8584355.493548388,6984378.81
4887,1,614000,5043,5122,6899,79,253.83,3325419.7044334975,6984378.81
4888,1,698000,5044,5122,6899,78,253.83,3325419.7044334975,6984378.81
4889,1,622000,5044,5122,6539,78,253.83,3325419.7044334975,6984378.81
4890,2,800000,5049,5080,6865,31,253.83,2989003.2716499544,6984378.81
4891,5,3000000,5051,5673,7218,622,253.83,1400922.5020242915,6984378.81
4892,12,1300000,5059,5161,6512,102,253.83,7658937.101338432,6984378.81
4893,17,825000,5062,5090,7012,28,253.83,1614143.0049603174,6984378.81
4894,12,950000,5069,5157,6715,88,253.83,7658937.101338432,6984378.81
4895,20,525000,5085,5085,8055,0,253.83,7597088.421768707,6984378.81
4896,15,958000,5086,5416,6800,330,253.83,4522577.48037889,6984378.81
4897,24,7500000,5086,5122,6304,36,253.83,23456062.532786883,6984378.81
4898,2,700000,5090,5315,8662,225,253.83,2989003.2716499544,6984378.81
4899,18,775000,5091,5111,6750,20,253.83,8584355.493548388,6984378.81
4900,1,650000,5091,5105,6322,14,253.83,3325419.7044334975,6984378.81
4901,17,715000,5099,5127,6322,28,253.83,1614143.0049603174,6984378.81
4902,15,800000,5099,5149,6535,50,253.83,4522577.48037889,6984378.81
4903,2,690000,5100,5143,8275,43,253.83,2989003.2716499544,6984378.81
4904,15,3500000,5100,5506,6575,406,253.83,4522577.48037889,6984378.81
4905,4,1300000,5101,5154,8103,53,253.83,4297914.794871795,6984378.81
4906,20,20000000,5104,5882,6970,778,253.83,7597088.421768707,6984378.81
4907,15,2000000,5106,5143,7681,37,253.83,4522577.48037889,6984378.81
4908,21,46424000,5108,6214,7433,1106,253.83,17091199.984,6984378.81
4909,24,83655000,5113,6386,7841,1273,253.83,23456062.532786883,6984378.81
4910,12,24500000,5121,5913,7596,792,253.83,7658937.101338432,6984378.81
4911,12,45500000,5121,5913,7596,792,253.83,7658937.101338432,6984378.81
4912,3,4500000,5128,5244,6760,116,253.83,9246769.549865229,6984378.81
4913,11,1000000,5133,5255,7733,122,253.83,1820371.57,6984378.81
4914,18,33666000,5134,6512,7618,1378,253.83,8584355.493548388,6984378.81
4915,16,650000,5134,5154,6494,20,253.83,2465023.1840707962,6984378.81
4916,18,165000000,5136,6512,7618,1376,253.83,8584355.493548388,6984378.81
4917,18,59745000,5136,6512,7618,1376,253.83,8584355.493548388,6984378.81
4918,3,750000,5140,5157,8089,17,253.83,9246769.549865229,6984378.81
4919,8,590000,5142,5286,6815,144,253.83,1501617.2191780822,6984378.81
4920,13,19000000,5143,5752,7351,609,253.83,7795654.71978022,6984378.81
4921,17,600000,5147,5307,6535,160,253.83,1614143.0049603174,6984378.81
4922,13,950000,5148,5328,8144,180,253.83,7795654.71978022,6984378.81
4923,8,600000,5150,5297,6801,147,253.83,1501617.2191780822,6984378.81
4924,8,600000,5150,5317,6801,167,253.83,1501617.2191780822,6984378.81
4925,3,657968,5150,5234,6338,84,253.83,9246769.549865229,6984378.81
4926,4,18000000,5155,5849,6871,694,253.83,4297914.794871795,6984378.81
4927,3,25000000,5161,5541,7502,380,253.83,9246769.549865229,6984378.81
4928,20,15000000,5176,5996,6375,820,253.83,7597088.421768707,6984378.81
4929,2,900000,5191,5212,6310,21,253.83,2989003.2716499544,6984378.81
4930,17,800000,5191,5273,6526,82,253.83,1614143.0049603174,6984378.81
4931,17,1000000,5192,5239,6322,47,253.83,1614143.0049603174,6984378.81
4932,24,600000,5192,5211,6751,19,253.83,23456062.532786883,6984378.81
4933,12,2000000,5192,5349,6778,157,253.83,7658937.101338432,6984378.81
4934,12,750000,5195,5216,6476,21,253.83,7658937.101338432,6984378.81
4935,24,4400000,5195,5345,7052,150,253.83,23456062.532786883,6984378.81
4936,19,6000000,5199,5834,6606,635,253.83,6721340.5708154505,6984378.81
4937,21,1163200,5203,5290,6329,87,253.83,17091199.984,6984378.81
4938,12,1000000,5209,5247,7550,38,246.12,7658937.101338432,6701891.81
4939,19,695000,5217,5269,8698,52,246.12,6721340.5708154505,6701891.81
4940,11,900000,5219,5234,7143,15,246.12,1820371.57,6701891.81
4941,8,528000,5223,5338,7326,115,246.12,1501617.2191780822,6701891.81
4942,6,600000,5230,5303,7291,73,246.12,1124713.2781954887,6701891.81
4943,0,3514000,5232,5932,6722,700,246.12,8418173.322222222,6701891.81
4944,0,3899000,5232,5932,6974,700,246.12,8418173.322222222,6701891.81
4945,0,3896200,5232,5932,7008,700,246.12,8418173.322222222,6701891.81
4946,0,3514000,5232,5932,7039,700,246.12,8418173.322222222,6701891.81
4947,11,572760,5232,5960,7634,728,246.12,1820371.57,6701891.81
4948,17,522360,5232,5274,6588,42,246.12,1614143.0049603174,6701891.81
4949,1,635160,5237,5265,7459,28,246.12,3325419.7044334975,6701891.81
4950,2,670000,5241,5366,7002,125,246.12,2989003.2716499544,6701891.81
4951,2,650000,5255,5801,7348,546,246.12,2989003.2716499544,6701891.81
4952,2,650000,5258,5294,6308,36,246.12,2989003.2716499544,6701891.81
4953,2,785772,5258,5295,6345,37,246.12,2989003.2716499544,6701891.81
4954,16,650000,5259,5274,7597,15,246.12,2465023.1840707962,6701891.81
4955,3,1500000,5266,5350,6567,84,246.12,9246769.549865229,6701891.81
4956,13,23000000,5269,6261,7715,992,246.12,7795654.71978022,6701891.81
4957,24,1000000,5273,5294,7299,21,246.12,23456062.532786883,6701891.81
4958,5,33000000,5275,6275,7435,1000,246.12,1400922.5020242915,6701891.81
4959,2,600000,5276,5407,6375,131,246.12,2989003.2716499544,6701891.81
4960,17,673896,5282,5308,6822,26,246.12,1614143.0049603174,6701891.81
4961,1,700000,5283,5315,7466,32,246.12,3325419.7044334975,6701891.81
4962,2,700000,5288,5328,7173,40,246.12,2989003.2716499544,6701891.81
4963,16,650000,5293,5336,6479,43,246.12,2465023.1840707962,6701891.81
4964,3,680000,5295,5332,6438,37,246.12,9246769.549865229,6701891.81
4965,11,600000,5297,5330,7340,33,246.12,1820371.57,6701891.81
4966,11,1100000,5297,5359,7345,62,246.12,1820371.57,6701891.81
4967,17,809456,5308,5400,6443,92,246.12,1614143.0049603174,6701891.81
4968,7,600000,5316,5373,7817,57,246.12,3738553.685483871,6701891.81
4969,7,600000,5316,5373,7817,57,246.12,3738553.685483871,6701891.81
4970,7,600000,5316,5373,7820,57,246.12,3738553.685483871,6701891.81
4971,7,600000,5316,5373,7822,57,246.12,3738553.685483871,6701891.81
4972,7,600000,5316,5373,7831,57,246.12,3738553.685483871,6701891.81
4973,7,600000,5316,5373,7815,57,246.12,3738553.685483871,6701891.81
4974,7,600000,5316,5373,7815,57,246.12,3738553.685483871,6701891.81
4975,2,800000,5321,5349,6310,28,246.12,2989003.2716499544,6701891.81
4976,2,725000,5332,5372,7652,40,246.12,2989003.2716499544,6701891.81
4977,19,520000,5336,5464,7305,128,246.12,6721340.5708154505,6701891.81
4978,13,1050000,5338,5475,6937,137,246.12,7795654.71978022,6701891.81
4979,12,12500000,5338,6864,7250,1526,246.12,7658937.101338432,6701891.81
4980,24,800000,5339,5343,7415,4,246.12,23456062.532786883,6701891.81
4981,2,750000,5343,5386,6462,43,246.12,2989003.2716499544,6701891.81
4982,1,800000,5351,5366,7627,15,246.12,3325419.7044334975,6701891.81
4983,0,800000,5351,5465,7981,114,246.12,8418173.322222222,6701891.81
4984,17,600000,5352,5381,6623,29,246.12,1614143.0049603174,6701891.81
4985,2,900000,5353,5645,6904,292,246.12,2989003.2716499544,6701891.81
4986,11,900000,5356,5472,6463,116,246.12,1820371.57,6701891.81
4987,16,620000,5356,5414,7351,58,246.12,2465023.1840707962,6701891.81
4988,2,650000,5358,5387,8650,29,246.12,2989003.2716499544,6701891.81
4989,24,49717000,5366,6389,6568,1023,246.12,23456062.532786883,6701891.81
4990,11,1500000,5366,5407,8213,41,246.12,1820371.57,6701891.81
4991,24,1000000,5372,5408,7605,36,246.12,23456062.532786883,6701891.81
4992,11,1000000,5373,5611,8429,238,246.12,1820371.57,6701891.81
4993,12,31000000,5378,5790,6876,412,246.12,7658937.101338432,6701891.81
4994,19,600000,5380,5401,6836,21,246.12,6721340.5708154505,6701891.81
4995,17,1000000,5381,5407,7185,26,246.12,1614143.0049603174,6701891.81
4996,16,900000,5384,5457,7166,73,246.12,2465023.1840707962,6701891.81
4997,12,1000000,5386,5405,6382,19,246.12,7658937.101338432,6701891.81
4998,12,1200000,5386,5533,7466,147,246.12,7658937.101338432,6701891.81
4999,12,700000,5388,5405,7635,17,246.12,7658937.101338432,6701891.81
5000,2,735000,5393,5433,6512,40,246.12,2989003.2716499544,6701891.81
5001,2,700000,5394,5617,7348,223,246.12,2989003.2716499544,6701891.81
5002,11,1200000,5394,5423,6494,29,246.12,1820371.57,6701891.81
5003,4,1000000,5395,5499,6529,104,246.12,4297914.794871795,6701891.81
5004,11,700000,5398,5407,8550,9,246.12,1820371.57,6701891.81
5005,2,700000,5398,5409,6780,11,246.12,2989003.2716499544,6701891.81
5006,2,625000,5401,5414,7897,13,246.12,2989003.2716499544,6701891.81
5007,22,550000,5402,5416,6589,14,246.12,2904103.2512077293,6701891.81
5008,2,750000,5409,5422,7809,13,246.12,2989003.2716499544,6701891.81
5009,12,800000,5412,5427,6308,15,246.12,7658937.101338432,6701891.81
5010,18,606000,5413,5437,7589,24,246.12,8584355.493548388,6701891.81
5011,16,750000,5414,5686,6682,272,246.12,2465023.1840707962,6701891.81
5012,12,1000000,5421,5430,6324,9,246.12,7658937.101338432,6701891.81
5013,11,1200000,5421,5482,6809,61,246.12,1820371.57,6701891.81
5014,13,700000,5427,5492,8800,65,246.12,7795654.71978022,6701891.81
5015,11,820000,5436,5486,8816,50,246.12,1820371.57,6701891.81
5016,15,600000,5440,5476,8102,36,246.12,4522577.48037889,6701891.81
5017,11,550000,5440,5465,8670,25,246.12,1820371.57,6701891.81
5018,19,700000,5441,5609,6731,168,246.12,6721340.5708154505,6701891.81
5019,16,650000,5441,5576,6351,135,246.12,2465023.1840707962,6701891.81
5020,5,715000,5443,5505,6648,62,246.12,1400922.5020242915,6701891.81
5021,11,900000,5444,5469,6463,25,246.12,1820371.57,6701891.81
5022,15,1000000,5454,5507,6315,53,246.12,4522577.48037889,6701891.81
5023,17,550000,5455,5461,6946,6,246.12,1614143.0049603174,6701891.81
5024,21,21800000,5456,7037,7561,1581,246.12,17091199.984,6701891.81
5025,11,1000000,5457,5539,6630,82,246.12,1820371.57,6701891.81
5026,2,550000,5461,5507,6766,46,246.12,2989003.2716499544,6701891.81
5027,12,750000,5463,5503,7638,40,246.12,7658937.101338432,6701891.81
5028,23,900000,5465,5485,7110,20,246.12,5772926.70157068,6701891.81
5029,17,594192,5470,5498,6393,28,246.12,1614143.0049603174,6701891.81
5030,21,1000000,5470,5976,8179,506,246.12,17091199.984,6701891.81
5031,16,900000,5478,5653,6651,175,246.12,2465023.1840707962,6701891.81
5032,19,900000,5483,5500,6387,17,246.12,6721340.5708154505,6701891.81
5033,3,600000,5483,5785,6471,302,246.12,9246769.549865229,6701891.81
5034,2,600000,5485,5665,6501,180,246.12,2989003.2716499544,6701891.81
5035,11,850000,5485,5507,6409,22,246.12,1820371.57,6701891.81
5036,16,650000,5491,5513,6493,22,246.12,2465023.1840707962,6701891.81
5037,17,1000000,5497,5528,7346,31,246.12,1614143.0049603174,6701891.81
5038,9,44000000,5506,6318,7080,812,246.12,3707403.8834951455,6701891.81
5039,16,850000,5507,5596,6477,89,246.12,2465023.1840707962,6701891.81
5040,24,3000000,5507,5532,7663,25,246.12,23456062.532786883,6701891.81
5041,24,20000000,5510,6596,6639,1086,246.12,23456062.532786883,6701891.81
5042,17,805456,5510,5525,6539,15,246.12,1614143.0049603174,6701891.81
5043,15,40000000,5511,6011,7809,500,246.12,4522577.48037889,6701891.81
5044,11,825000,5513,5678,6519,165,246.12,1820371.57,6701891.81
5045,11,1250000,5513,5533,7199,20,246.12,1820371.57,6701891.81
5046,18,600000,5520,5573,6540,53,246.12,8584355.493548388,6701891.81
5047,17,750000,5525,5539,6911,14,246.12,1614143.0049603174,6701891.81
5048,16,700000,5532,5680,6893,148,246.12,2465023.1840707962,6701891.81
5049,17,600000,5533,5573,6504,40,246.12,1614143.0049603174,6701891.81
5050,2,715000,5533,5541,6431,8,246.12,2989003.2716499544,6701891.81
5051,1,34200000,5534,6052,6792,518,246.12,3325419.7044334975,6701891.81
5052,17,80000000,5534,6907,7295,1373,246.12,1614143.0049603174,6701891.81
5053,17,20000000,5534,6612,7295,1078,246.12,1614143.0049603174,6701891.81
5054,1,7600000,5534,6043,6791,509,246.12,3325419.7044334975,6701891.81
5055,18,750000,5539,5637,6745,98,246.12,8584355.493548388,6701891.81
5056,21,300000000,5540,7250,8360,1710,246.12,17091199.984,6701891.81
5057,11,1200000,5541,5584,6854,43,246.12,1820371.57,6701891.81
5058,15,56000000,5546,6479,7137,933,246.12,4522577.48037889,6701891.81
5059,16,900000,5552,5645,6422,93,246.12,2465023.1840707962,6701891.81
5060,12,25000000,5552,6722,7382,1170,246.12,7658937.101338432,6701891.81
5061,1,584000,5553,5587,7653,34,246.12,3325419.7044334975,6701891.81
5062,12,7400000,5553,7064,7926,1511,246.12,7658937.101338432,6701891.81
5063,12,20000000,5553,7064,7926,1511,246.12,7658937.101338432,6701891.81
5064,0,32000000,5555,6501,7151,946,246.12,8418173.322222222,6701891.81
5065,17,50000000,5556,7313,8572,1757,246.12,1614143.0049603174,6701891.81
5066,18,1000000,5556,5737,8765,181,246.12,8584355.493548388,6701891.81
5067,24,2500000,5556,5598,7633,42,246.12,23456062.532786883,6701891.81
5068,11,1030000,5560,5581,6864,21,246.12,1820371.57,6701891.81
5069,9,38388600,5560,6206,7694,646,246.12,3707403.8834951455,6701891.81
5070,9,22271400,5560,6553,7654,993,246.12,3707403.8834951455,6701891.81
5071,9,5000000,5560,5779,7690,219,246.12,3707403.8834951455,6701891.81
5072,11,850000,5567,5582,7372,15,246.12,1820371.57,6701891.81
5073,2,850000,5574,5623,6760,49,104.75,2989003.2716499544,3369660.19
5074,2,700000,5582,5597,6329,15,104.75,2989003.2716499544,3369660.19
5075,2,604000,5587,5610,6338,23,104.75,2989003.2716499544,3369660.19
5076,23,1100000,5588,5644,7282,56,104.75,5772926.70157068,3369660.19
5077,16,620000,5589,5633,7397,44,104.75,2465023.1840707962,3369660.19
5078,16,570000,5589,5633,6830,44,104.75,2465023.1840707962,3369660.19
5079,6,531126,5591,5780,7677,189,104.75,1124713.2781954887,3369660.19
5080,18,900000,5591,5604,6469,13,104.75,8584355.493548388,3369660.19
5081,11,700000,5595,5610,7071,15,104.75,1820371.57,3369660.19
5082,11,700000,5596,5667,6308,71,104.75,1820371.57,3369660.19
5083,19,750000,5597,5624,6903,27,104.75,6721340.5708154505,3369660.19
5084,11,560000,5597,5630,6347,33,104.75,1820371.57,3369660.19
5085,6,790000,5597,5811,7677,214,104.75,1124713.2781954887,3369660.19
5086,12,1500000,5603,5617,8101,14,104.75,7658937.101338432,3369660.19
5087,2,825000,5609,5658,6471,49,104.75,2989003.2716499544,3369660.19
5088,2,600000,5612,5667,7262,55,104.75,2989003.2716499544,3369660.19
5089,2,600000,5612,5630,6366,18,104.75,2989003.2716499544,3369660.19
5090,3,900000,5612,5731,6619,119,104.75,9246769.549865229,3369660.19
5091,17,785000,5619,5651,7893,32,104.75,1614143.0049603174,3369660.19
5092,12,1000000,5623,5637,7465,14,104.75,7658937.101338432,3369660.19
5093,11,750000,5629,5637,7851,8,104.75,1820371.57,3369660.19
5094,5,600000,5631,5647,6361,16,104.75,1400922.5020242915,3369660.19
5095,22,550000,5632,6001,6387,369,104.75,2904103.2512077293,3369660.19
5096,11,1090000,5633,5637,6326,4,104.75,1820371.57,3369660.19
5097,11,1200000,5633,5645,6435,12,104.75,1820371.57,3369660.19
5098,16,700000,5633,5650,6794,17,104.75,2465023.1840707962,3369660.19
5099,5,900000,5637,5715,6330,78,104.75,1400922.5020242915,3369660.19
5100,2,800000,5638,5675,6395,37,104.75,2989003.2716499544,3369660.19
5101,2,800000,5638,5695,7824,57,104.75,2989003.2716499544,3369660.19
5102,1,850000,5643,5672,6553,29,104.75,3325419.7044334975,3369660.19
5103,3,1000000,5644,5678,6690,34,104.75,9246769.549865229,3369660.19
5104,2,750000,5644,5654,6368,10,104.75,2989003.2716499544,3369660.19
5105,2,750000,5646,5679,6303,33,104.75,2989003.2716499544,3369660.19
5106,4,750000,5646,5699,6630,53,104.75,4297914.794871795,3369660.19
5107,11,750000,5650,5666,6554,16,104.75,1820371.57,3369660.19
5108,6,565100,5652,6392,7918,740,104.75,1124713.2781954887,3369660.19
5109,12,530000,5652,5850,6549,198,104.75,7658937.101338432,3369660.19
5110,17,929106,5653,5685,6371,32,104.75,1614143.0049603174,3369660.19
5111,11,600000,5654,5773,6955,119,104.75,1820371.57,3369660.19
5112,11,1597000,5657,5674,6975,17,104.75,1820371.57,3369660.19
5113,11,1430000,5657,5681,6309,24,104.75,1820371.57,3369660.19
5114,17,750000,5657,5672,6465,15,104.75,1614143.0049603174,3369660.19
5115,12,1200000,5657,5687,7165,30,104.75,7658937.101338432,3369660.19
5116,17,600000,5659,5687,6889,28,104.75,1614143.0049603174,3369660.19
5117,2,600000,5660,5686,6312,26,104.75,2989003.2716499544,3369660.19
5118,2,575000,5660,5680,6904,20,104.75,2989003.2716499544,3369660.19
5119,17,581800,5666,5955,6539,289,104.75,1614143.0049603174,3369660.19
5120,17,614238,5666,5687,6430,21,104.75,1614143.0049603174,3369660.19
5121,2,600000,5668,5777,7348,109,104.75,2989003.2716499544,3369660.19
5122,2,700000,5671,5825,6357,154,104.75,2989003.2716499544,3369660.19
5123,2,550000,5674,5723,6701,49,104.75,2989003.2716499544,3369660.19
5124,2,700000,5675,5694,6410,19,104.75,2989003.2716499544,3369660.19
5125,11,31000000,5678,6276,6996,598,104.75,1820371.57,3369660.19
5126,11,8550000,5678,6276,7005,598,104.75,1820371.57,3369660.19
5127,2,975000,5678,5686,7079,8,104.75,2989003.2716499544,3369660.19
5128,15,800000,5679,5742,8717,63,104.75,4522577.48037889,3369660.19
5129,17,766028,5679,5728,6443,49,104.75,1614143.0049603174,3369660.19
5130,2,870000,5679,5714,6303,35,104.75,2989003.2716499544,3369660.19
5131,4,600000,5680,5713,6504,33,104.75,4297914.794871795,3369660.19
5132,18,800000,5680,5692,7309,12,104.75,8584355.493548388,3369660.19
5133,11,1100000,5680,5779,6583,99,104.75,1820371.57,3369660.19
5134,14,550000,5682,5736,6592,54,104.75,5826416.914893617,3369660.19
5135,11,1300000,5682,5785,6666,103,104.75,1820371.57,3369660.19
5136,11,675000,5682,5717,6312,35,104.75,1820371.57,3369660.19
5137,17,716112,5682,5714,6386,32,104.75,1614143.0049603174,3369660.19
5138,2,600000,5685,5729,6563,44,104.75,2989003.2716499544,3369660.19
5139,11,800000,5685,5731,6709,46,104.75,1820371.57,3369660.19
5140,2,730000,5685,5709,6840,24,104.75,2989003.2716499544,3369660.19
5141,22,551000,5686,5708,6958,22,104.75,2904103.2512077293,3369660.19
5142,16,900000,5686,5714,7338,28,104.75,2465023.1840707962,3369660.19
5143,17,730428,5687,5877,8157,190,104.75,1614143.0049603174,3369660.19
5144,17,921240,5688,5734,6751,46,104.75,1614143.0049603174,3369660.19
5145,3,50000000,5689,6939,7908,1250,104.75,9246769.549865229,3369660.19
5146,1,750000,5690,5709,6457,19,104.75,3325419.7044334975,3369660.19
5147,15,700000,5690,5710,6479,20,104.75,4522577.48037889,3369660.19
5148,14,580000,5692,5736,6749,44,104.75,5826416.914893617,3369660.19
5149,19,550000,5692,5832,6935,140,104.75,6721340.5708154505,3369660.19
5150,2,530000,5694,5780,6520,86,104.75,2989003.2716499544,3369660.19
5151,23,1000000,5696,5710,6416,14,104.75,5772926.70157068,3369660.19
5152,12,1200000,5700,5735,6492,35,104.75,7658937.101338432,3369660.19
5153,11,1000000,5700,5710,6388,10,104.75,1820371.57,3369660.19
5154,11,1000000,5700,5749,8005,49,104.75,1820371.57,3369660.19
5155,11,800000,5701,5730,6623,29,104.75,1820371.57,3369660.19
5156,17,613800,5701,5825,6766,124,104.75,1614143.0049603174,3369660.19
5157,11,1750000,5702,5770,7387,68,104.75,1820371.57,3369660.19
5158,17,534000,5702,5720,6360,18,104.75,1614143.0049603174,3369660.19
5159,19,800000,5703,5745,6385,42,104.75,6721340.5708154505,3369660.19
5160,15,600000,5707,5723,6536,16,104.75,4522577.48037889,3369660.19
5161,2,650000,5708,5748,6337,40,104.75,2989003.2716499544,3369660.19
5162,2,685000,5708,5748,7662,40,104.75,2989003.2716499544,3369660.19
5163,11,650000,5709,5752,6491,43,104.75,1820371.57,3369660.19
5164,11,640000,5709,5771,8439,62,104.75,1820371.57,3369660.19
5165,3,800000,5709,5762,7221,53,104.75,9246769.549865229,3369660.19
5166,1,597376,5710,5829,6424,119,104.75,3325419.7044334975,3369660.19
5167,2,560000,5710,5765,6332,55,104.75,2989003.2716499544,3369660.19
5168,17,800000,5715,5756,6654,41,104.75,1614143.0049603174,3369660.19
5169,17,750000,5715,5735,6801,20,104.75,1614143.0049603174,3369660.19
5170,19,600000,5716,5731,6338,15,104.75,6721340.5708154505,3369660.19
5171,22,630000,5717,5765,7453,48,104.75,2904103.2512077293,3369660.19
5172,18,770000,5720,5730,6744,10,104.75,8584355.493548388,3369660.19
5173,16,600000,5721,5738,7688,17,104.75,2465023.1840707962,3369660.19
5174,2,800000,5721,5730,7137,9,104.75,2989003.2716499544,3369660.19
5175,19,700000,5721,5735,6325,14,104.75,6721340.5708154505,3369660.19
5176,18,700000,5721,5766,6682,45,104.75,8584355.493548388,3369660.19
5177,17,600000,5722,5776,6991,54,104.75,1614143.0049603174,3369660.19
5178,17,602016,5723,5764,6626,41,104.75,1614143.0049603174,3369660.19
5179,22,650000,5723,5737,7457,14,104.75,2904103.2512077293,3369660.19
5180,11,800000,5723,5751,7907,28,104.75,1820371.57,3369660.19
5181,15,600000,5724,5734,6693,10,104.75,4522577.48037889,3369660.19
5182,17,840560,5724,5743,8716,19,104.75,1614143.0049603174,3369660.19
5183,11,1000000,5727,5743,6368,16,104.75,1820371.57,3369660.19
5184,11,750000,5727,5764,6491,37,104.75,1820371.57,3369660.19
5185,2,750000,5727,5738,7681,11,104.75,2989003.2716499544,3369660.19
5186,11,800000,5727,5744,6827,17,104.75,1820371.57,3369660.19
5187,17,595000,5727,5743,6695,16,104.75,1614143.0049603174,3369660.19
5188,2,600000,5728,5744,6514,16,104.75,2989003.2716499544,3369660.19
5189,11,1000000,5730,5759,6617,29,104.75,1820371.57,3369660.19
5190,19,1000000,5730,6786,8510,1056,104.75,6721340.5708154505,3369660.19
5191,12,2000000,5730,5763,7613,33,104.75,7658937.101338432,3369660.19
5192,1,727600,5734,5819,6626,85,104.75,3325419.7044334975,3369660.19
5193,2,610000,5734,5778,6444,44,104.75,2989003.2716499544,3369660.19
5194,17,503582,5734,5759,6365,25,104.75,1614143.0049603174,3369660.19
5195,2,750000,5735,5755,6428,20,104.75,2989003.2716499544,3369660.19
5196,4,800000,5735,5850,6378,115,104.75,4297914.794871795,3369660.19
5197,11,600000,5736,5755,7085,19,104.75,1820371.57,3369660.19
5198,24,113000000,5737,6640,8205,903,104.75,23456062.532786883,3369660.19
5199,11,820000,5737,5773,6401,36,104.75,1820371.57,3369660.19
5200,2,1300000,5738,5797,8087,59,104.75,2989003.2716499544,3369660.19
5201,17,650664,5741,5756,8102,15,104.75,1614143.0049603174,3369660.19
5202,2,3000000,5742,5793,7198,51,104.75,2989003.2716499544,3369660.19
5203,2,800000,5743,5778,6497,35,104.75,2989003.2716499544,3369660.19
5204,2,575000,5744,5773,6345,29,104.75,2989003.2716499544,3369660.19
5205,11,600000,5748,5819,6863,71,104.75,1820371.57,3369660.19
5206,24,1200000,5749,5764,6960,15,104.75,23456062.532786883,3369660.19
5207,11,1000000,5749,5962,7540,213,104.75,1820371.57,3369660.19
5208,2,650000,5749,5778,6338,29,104.75,2989003.2716499544,3369660.19
5209,16,620000,5751,5833,6987,82,104.75,2465023.1840707962,3369660.19
5210,4,675000,5752,5769,6539,17,104.75,4297914.794871795,3369660.19
5211,15,600000,5752,5801,8831,49,104.75,4522577.48037889,3369660.19
5212,11,1500000,5754,5771,6512,17,104.75,1820371.57,3369660.19
5213,22,2160000,5755,6322,6486,567,104.75,2904103.2512077293,3369660.19
5214,22,2160000,5755,6322,6486,567,104.75,2904103.2512077293,3369660.19
5215,5,660000,5755,5769,7501,14,104.75,1400922.5020242915,3369660.19
5216,11,2000000,5756,5765,6757,9,104.75,1820371.57,3369660.19
5217,11,700000,5756,5797,6315,41,104.75,1820371.57,3369660.19
5218,2,685000,5757,5787,7305,30,104.75,2989003.2716499544,3369660.19
5219,11,800000,5757,5793,6485,36,104.75,1820371.57,3369660.19
5220,1,600000,5758,5776,6723,18,104.75,3325419.7044334975,3369660.19
5221,16,600000,5759,5787,7500,28,104.75,2465023.1840707962,3369660.19
5222,6,600000,5762,5994,6707,232,104.75,1124713.2781954887,3369660.19
5223,18,1500000,5763,5890,7337,127,104.75,8584355.493548388,3369660.19
5224,11,1400000,5764,5780,6332,16,104.75,1820371.57,3369660.19
5225,1,707960,5764,5793,6568,29,104.75,3325419.7044334975,3369660.19
5226,21,4000000,5764,5841,6388,77,104.75,17091199.984,3369660.19
5227,19,730000,5766,5779,7926,13,104.75,6721340.5708154505,3369660.19
5228,14,530000,5766,5805,6303,39,104.75,5826416.914893617,3369660.19
5229,4,700000,5766,6000,6632,234,104.75,4297914.794871795,3369660.19
5230,11,1230000,5769,5898,6862,129,104.75,1820371.57,3369660.19
5231,11,1200000,5770,5784,7673,14,104.75,1820371.57,3369660.19
5232,11,700000,5770,5854,6498,84,104.75,1820371.57,3369660.19
5233,2,710000,5771,5807,6969,36,104.75,2989003.2716499544,3369660.19
5234,2,700000,5771,5958,6567,187,104.75,2989003.2716499544,3369660.19
5235,24,4000000,5772,5856,8254,84,104.75,23456062.532786883,3369660.19
5236,2,700000,5772,5787,7206,15,104.75,2989003.2716499544,3369660.19
5237,2,730000,5777,5822,6371,45,104.75,2989003.2716499544,3369660.19
5238,12,1000000,5777,5805,6632,28,104.75,7658937.101338432,3369660.19
5239,2,670000,5777,6009,6787,232,104.75,2989003.2716499544,3369660.19
5240,17,2500000,5778,5815,6717,37,104.75,1614143.0049603174,3369660.19
5241,15,600000,5779,5814,8277,35,104.75,4522577.48037889,3369660.19
5242,12,700000,5780,5843,7208,63,104.75,7658937.101338432,3369660.19
5243,1,720702,5784,5819,6387,35,104.75,3325419.7044334975,3369660.19
5244,21,600000,5784,5923,8327,139,104.75,17091199.984,3369660.19
5245,16,850000,5786,5848,6498,62,104.75,2465023.1840707962,3369660.19
5246,17,2000000,5786,5821,7305,35,104.75,1614143.0049603174,3369660.19
5247,11,750000,5787,5822,6436,35,104.75,1820371.57,3369660.19
5248,16,700000,5791,5839,8688,48,104.75,2465023.1840707962,3369660.19
5249,1,1000000,5791,5828,6861,37,104.75,3325419.7044334975,3369660.19
5250,2,650000,5792,6276,8152,484,104.75,2989003.2716499544,3369660.19
5251,2,650000,5792,6330,7968,538,104.75,2989003.2716499544,3369660.19
5252,2,510000,5793,5805,7137,12,104.75,2989003.2716499544,3369660.19
5253,11,845000,5793,5820,6393,27,104.75,1820371.57,3369660.19
5254,16,680000,5794,5839,6354,45,104.75,2465023.1840707962,3369660.19
5255,11,800000,5797,5825,6619,28,104.75,1820371.57,3369660.19
5256,11,635500,5800,5815,6343,15,104.75,1820371.57,3369660.19
5257,11,2000000,5800,5846,7688,46,104.75,1820371.57,3369660.19
5258,15,3832000,5805,5822,6338,17,104.75,4522577.48037889,3369660.19
5259,1,15000000,5806,6814,7432,1008,104.75,3325419.7044334975,3369660.19
5260,2,519000,5807,5959,7829,152,104.75,2989003.2716499544,3369660.19
5261,16,1100000,5807,5832,7218,25,104.75,2465023.1840707962,3369660.19
5262,2,575000,5807,5959,7830,152,104.75,2989003.2716499544,3369660.19
5263,12,600000,5807,5841,6596,34,104.75,7658937.101338432,3369660.19
5264,1,2000000,5811,6959,7435,1148,104.75,3325419.7044334975,3369660.19
5265,1,516440,5811,5834,6494,23,104.75,3325419.7044334975,3369660.19
5266,18,825000,5811,5828,6308,17,104.75,8584355.493548388,3369660.19
5267,2,757000,5812,5870,6644,58,104.75,2989003.2716499544,3369660.19
5268,1,900000,5812,5825,7061,13,104.75,3325419.7044334975,3369660.19
5269,11,1500000,5819,5848,6931,29,104.75,1820371.57,3369660.19
5270,4,12000000,5819,6480,6829,661,104.75,4297914.794871795,3369660.19
5271,11,3500000,5820,5847,6639,27,104.75,1820371.57,3369660.19
5272,2,600000,5820,5847,6728,27,104.75,2989003.2716499544,3369660.19
5273,24,30000000,5820,6560,7305,740,104.75,23456062.532786883,3369660.19
5274,17,595572,5821,5871,6309,50,104.75,1614143.0049603174,3369660.19
5275,17,621708,5821,5855,6310,34,104.75,1614143.0049603174,3369660.19
5276,11,800000,5822,5849,6346,27,104.75,1820371.57,3369660.19
5277,2,900000,5826,5847,6332,21,104.75,2989003.2716499544,3369660.19
5278,19,1500000,5826,5847,6511,21,104.75,6721340.5708154505,3369660.19
5279,17,1350000,5827,5842,6724,15,104.75,1614143.0049603174,3369660.19
5280,11,1300000,5827,5841,6732,14,104.75,1820371.57,3369660.19
5281,15,550000,5828,5868,6701,40,104.75,4522577.48037889,3369660.19
5282,12,600000,5828,5855,6759,27,104.75,7658937.101338432,3369660.19
5283,12,600000,5828,5874,6759,46,104.75,7658937.101338432,3369660.19
5284,11,1000000,5828,5842,8768,14,104.75,1820371.57,3369660.19
5285,17,750000,5829,5860,7159,31,104.75,1614143.0049603174,3369660.19
5286,2,600000,5832,5855,6324,23,104.75,2989003.2716499544,3369660.19
5287,6,1000000,5832,5959,7919,127,104.75,1124713.2781954887,3369660.19
5288,2,700000,5834,5848,6669,14,104.75,2989003.2716499544,3369660.19
5289,2,525000,5834,5861,8355,27,104.75,2989003.2716499544,3369660.19
5290,15,83000000,5835,6865,8676,1030,104.75,4522577.48037889,3369660.19
5291,2,650000,5839,5855,6739,16,104.75,2989003.2716499544,3369660.19
5292,11,690000,5839,5891,6357,52,104.75,1820371.57,3369660.19
5293,3,5000000,5840,5982,7102,142,104.75,9246769.549865229,3369660.19
5294,1,850000,5840,5884,7529,44,104.75,3325419.7044334975,3369660.19
5295,11,785000,5842,5861,6477,19,104.75,1820371.57,3369660.19
5296,15,520000,5847,6106,6465,259,104.75,4522577.48037889,3369660.19
5297,19,600000,5847,5864,6323,17,104.75,6721340.5708154505,3369660.19
5298,17,639280,5848,5871,6736,23,104.75,1614143.0049603174,3369660.19
5299,2,950000,5849,5868,7438,19,104.75,2989003.2716499544,3369660.19
5300,16,750000,5849,5864,6561,15,104.75,2465023.1840707962,3369660.19
5301,16,600000,5849,5898,6358,49,104.75,2465023.1840707962,3369660.19
5302,17,815600,5850,5878,6912,28,104.75,1614143.0049603174,3369660.19
5303,3,1200000,5850,5870,6379,20,104.75,9246769.549865229,3369660.19
5304,12,1000000,5854,5868,6983,14,104.75,7658937.101338432,3369660.19
5305,2,800000,5855,5870,7348,15,104.75,2989003.2716499544,3369660.19
5306,4,55000000,5856,6679,7124,823,104.75,4297914.794871795,3369660.19
5307,12,1000000,5857,5899,7836,42,104.75,7658937.101338432,3369660.19
5308,2,800000,5860,5871,8499,11,104.75,2989003.2716499544,3369660.19
5309,12,1250000,5860,5895,6375,35,104.75,7658937.101338432,3369660.19
5310,12,1250000,5860,5895,6375,35,104.75,7658937.101338432,3369660.19
5311,2,705000,5861,5910,6466,49,104.75,2989003.2716499544,3369660.19
5312,2,800000,5861,5891,6745,30,104.75,2989003.2716499544,3369660.19
5313,2,620000,5862,5876,6309,14,104.75,2989003.2716499544,3369660.19
5314,2,700000,5863,5988,6842,125,104.75,2989003.2716499544,3369660.19
5315,2,700000,5863,5876,6365,13,104.75,2989003.2716499544,3369660.19
5316,11,1000000,5863,5882,6842,19,104.75,1820371.57,3369660.19
5317,11,1800000,5864,6002,7137,138,104.75,1820371.57,3369660.19
5318,18,800000,5864,5876,7361,12,104.75,8584355.493548388,3369660.19
5319,2,1000000,5867,5888,7565,21,104.75,2989003.2716499544,3369660.19
5320,2,600000,5868,5885,6534,17,104.75,2989003.2716499544,3369660.19
5321,2,650000,5868,5889,6380,21,104.75,2989003.2716499544,3369660.19
5322,3,2600000,5868,5878,6849,10,104.75,9246769.549865229,3369660.19
5323,11,1000000,5869,5902,6347,33,104.75,1820371.57,3369660.19
5324,19,640000,5869,5892,8916,23,104.75,6721340.5708154505,3369660.19
5325,1,1200000,5869,5895,6555,26,104.75,3325419.7044334975,3369660.19
5326,19,700000,5869,5906,6388,37,104.75,6721340.5708154505,3369660.19
5327,11,880000,5870,5951,7338,81,104.75,1820371.57,3369660.19
5328,16,535000,5871,5895,6632,24,104.75,2465023.1840707962,3369660.19
5329,2,850000,5871,5888,8744,17,104.75,2989003.2716499544,3369660.19
5330,2,670000,5875,6092,7299,217,104.75,2989003.2716499544,3369660.19
5331,21,1500000,5875,5980,6574,105,104.75,17091199.984,3369660.19
5332,11,565500,5876,5912,6484,36,104.75,1820371.57,3369660.19
5333,11,1000000,5877,5904,6395,27,104.75,1820371.57,3369660.19
5334,17,640868,5877,5919,7431,42,104.75,1614143.0049603174,3369660.19
5335,2,530000,5878,5896,7639,18,104.75,2989003.2716499544,3369660.19
5336,19,1100000,5881,5905,6428,24,104.75,6721340.5708154505,3369660.19
5337,17,1000000,5881,5909,6596,28,104.75,1614143.0049603174,3369660.19
5338,17,1000000,5882,5897,6458,15,104.75,1614143.0049603174,3369660.19
5339,21,4000000,5882,5948,7983,66,104.75,17091199.984,3369660.19
5340,17,750000,5882,5933,6395,51,104.75,1614143.0049603174,3369660.19
5341,23,4500000,5882,6620,7361,738,104.75,5772926.70157068,3369660.19
5342,16,850000,5882,5932,6977,50,104.75,2465023.1840707962,3369660.19
5343,2,700000,5882,5904,6787,22,104.75,2989003.2716499544,3369660.19
5344,12,600000,5884,5926,7260,42,104.75,7658937.101338432,3369660.19
5345,12,1800000,5885,5997,6813,112,104.75,7658937.101338432,3369660.19
5346,11,750000,5885,5910,7185,25,104.75,1820371.57,3369660.19
5347,17,634000,5888,6680,7830,792,104.75,1614143.0049603174,3369660.19
5348,17,634368,5888,6680,7830,792,104.75,1614143.0049603174,3369660.19
5349,2,690000,5890,5918,6561,28,104.75,2989003.2716499544,3369660.19
5350,2,650000,5891,5955,7649,64,104.75,2989003.2716499544,3369660.19
5351,17,600000,5891,5918,6345,27,104.75,1614143.0049603174,3369660.19
5352,17,804480,5892,5918,6477,26,104.75,1614143.0049603174,3369660.19
5353,9,3500000,5892,6093,6618,201,104.75,3707403.8834951455,3369660.19
5354,2,700000,5895,6056,8662,161,104.75,2989003.2716499544,3369660.19
5355,17,775000,5898,5947,6354,49,104.75,1614143.0049603174,3369660.19
5356,24,2000000,5899,5953,6942,54,104.75,23456062.532786883,3369660.19
5357,2,750000,5902,5974,7453,72,104.75,2989003.2716499544,3369660.19
5358,24,1000000,5903,5945,6478,42,104.75,23456062.532786883,3369660.19
5359,21,2750000,5904,5973,7248,69,104.75,17091199.984,3369660.19
5360,5,700000,5909,5974,6616,65,104.75,1400922.5020242915,3369660.19
5361,11,1100000,5911,5937,7064,26,104.75,1820371.57,3369660.19
5362,11,600000,5913,5960,6449,47,104.75,1820371.57,3369660.19
5363,4,12000000,5924,6634,7066,710,104.75,4297914.794871795,3369660.19
5364,18,630000,5925,5966,6864,41,104.75,8584355.493548388,3369660.19
5365,2,600000,5925,5948,6553,23,104.75,2989003.2716499544,3369660.19
5366,17,600000,5925,5946,6977,21,104.75,1614143.0049603174,3369660.19
5367,12,1000000,5925,5939,6597,14,104.75,7658937.101338432,3369660.19
5368,11,1000000,5926,5948,7535,22,104.75,1820371.57,3369660.19
5369,11,1000000,5931,5959,6780,28,104.75,1820371.57,3369660.19
5370,11,1600000,5932,5946,7164,14,104.75,1820371.57,3369660.19
5371,11,938832,5932,5954,6744,22,104.75,1820371.57,3369660.19
5372,2,800000,5938,6025,6472,87,141.64,2989003.2716499544,5089136.37
5373,11,650000,5941,5960,6683,19,141.64,1820371.57,5089136.37
5374,11,2000000,5941,6065,7334,124,141.64,1820371.57,5089136.37
5375,2,805000,5944,6007,6749,63,141.64,2989003.2716499544,5089136.37
5376,18,540000,5947,5988,7717,41,141.64,8584355.493548388,5089136.37
5377,2,800000,5947,5966,6631,19,141.64,2989003.2716499544,5089136.37
5378,17,1200000,5947,5962,7625,15,141.64,1614143.0049603174,5089136.37
5379,16,610000,5948,5962,6750,14,141.64,2465023.1840707962,5089136.37
5380,5,700000,5952,5982,6774,30,141.64,1400922.5020242915,5089136.37
5381,19,535000,5952,5987,6693,35,141.64,6721340.5708154505,5089136.37
5382,17,950000,5953,5986,8348,33,141.64,1614143.0049603174,5089136.37
5383,2,570000,5955,5962,6653,7,141.64,2989003.2716499544,5089136.37
5384,2,570000,5955,5974,6610,19,141.64,2989003.2716499544,5089136.37
5385,2,620000,5958,5975,7962,17,141.64,2989003.2716499544,5089136.37
5386,23,1000000,5958,6052,8053,94,141.64,5772926.70157068,5089136.37
5387,12,700000,5960,5989,6457,29,141.64,7658937.101338432,5089136.37
5388,12,2000000,5961,6035,7323,74,141.64,7658937.101338432,5089136.37
5389,16,1500000,5962,5982,7563,20,141.64,2465023.1840707962,5089136.37
5390,2,700000,5962,5981,6540,19,141.64,2989003.2716499544,5089136.37
5391,11,660000,5965,6023,6333,58,141.64,1820371.57,5089136.37
5392,2,550000,5965,6364,6857,399,141.64,2989003.2716499544,5089136.37
5393,16,1000000,5966,6149,6631,183,141.64,2465023.1840707962,5089136.37
5394,17,900000,5967,5972,8265,5,141.64,1614143.0049603174,5089136.37
5395,11,1080000,5968,6007,7263,39,141.64,1820371.57,5089136.37
5396,1,607500,5969,6501,8020,532,141.64,3325419.7044334975,5089136.37
5397,11,715000,5969,5993,6653,24,141.64,1820371.57,5089136.37
5398,17,700000,5972,5996,6653,24,141.64,1614143.0049603174,5089136.37
5399,2,800000,5972,6007,6374,35,141.64,2989003.2716499544,5089136.37
5400,20,16000000,5972,7114,7291,1142,141.64,7597088.421768707,5089136.37
5401,15,900000,5973,6016,6421,43,141.64,4522577.48037889,5089136.37
5402,13,800000,5974,6037,7372,63,141.64,7795654.71978022,5089136.37
5403,2,870000,5974,5990,7261,16,141.64,2989003.2716499544,5089136.37
5404,16,700000,5974,5987,7837,13,141.64,2465023.1840707962,5089136.37
5405,2,600000,5975,6042,6449,67,141.64,2989003.2716499544,5089136.37
5406,12,1350000,5975,6008,7960,33,141.64,7658937.101338432,5089136.37
5407,17,800000,5976,6115,6568,139,141.64,1614143.0049603174,5089136.37
5408,17,737095,5981,6066,7101,85,141.64,1614143.0049603174,5089136.37
5409,18,620000,5981,6088,8538,107,141.64,8584355.493548388,5089136.37
5410,15,600000,5981,6015,6451,34,141.64,4522577.48037889,5089136.37
5411,24,4000000,5982,6043,6422,61,141.64,23456062.532786883,5089136.37
5412,17,900000,5983,6023,6431,40,141.64,1614143.0049603174,5089136.37
5413,22,525000,5983,6016,6367,33,141.64,2904103.2512077293,5089136.37
5414,2,600000,5986,6046,6455,60,141.64,2989003.2716499544,5089136.37
5415,2,600000,5986,6046,6455,60,141.64,2989003.2716499544,5089136.37
5416,15,600000,5988,6052,6409,64,141.64,4522577.48037889,5089136.37
5417,2,570000,5988,6003,6610,15,141.64,2989003.2716499544,5089136.37
5418,17,600000,5989,6072,7022,83,141.64,1614143.0049603174,5089136.37
5419,12,1000000,5990,6009,7585,19,141.64,7658937.101338432,5089136.37
5420,7,550000,5990,6037,6728,47,141.64,3738553.685483871,5089136.37
5421,18,800000,5994,6032,6603,38,141.64,8584355.493548388,5089136.37
5422,11,1300000,5995,6049,8170,54,141.64,1820371.57,5089136.37
5423,24,65000000,5996,6772,7708,776,141.64,23456062.532786883,5089136.37
5424,17,600000,5996,6088,8321,92,141.64,1614143.0049603174,5089136.37
5425,11,750000,6003,6023,6814,20,141.64,1820371.57,5089136.37
5426,11,850000,6003,6022,6555,19,141.64,1820371.57,5089136.37
5427,15,600000,6003,6049,6681,46,141.64,4522577.48037889,5089136.37
5428,15,750000,6004,6024,6477,20,141.64,4522577.48037889,5089136.37
5429,17,750000,6004,6030,6735,26,141.64,1614143.0049603174,5089136.37
5430,21,750000,6004,6106,8790,102,141.64,17091199.984,5089136.37
5431,2,860000,6004,6029,8585,25,141.64,2989003.2716499544,5089136.37
5432,24,350000000,6007,7527,8136,1520,141.64,23456062.532786883,5089136.37
5433,11,900000,6008,6031,6632,23,141.64,1820371.57,5089136.37
5434,21,1000000,6008,6063,6339,55,141.64,17091199.984,5089136.37
5435,3,540000,6010,6046,7018,36,141.64,9246769.549865229,5089136.37
5436,11,628000,6010,6035,6905,25,141.64,1820371.57,5089136.37
5437,12,1000000,6010,6045,7248,35,141.64,7658937.101338432,5089136.37
5438,12,2100000,6017,6043,6970,26,141.64,7658937.101338432,5089136.37
5439,11,720000,6017,6169,7197,152,141.64,1820371.57,5089136.37
5440,2,700000,6017,6031,6801,14,141.64,2989003.2716499544,5089136.37
5441,2,800000,6022,6087,6891,65,141.64,2989003.2716499544,5089136.37
5442,17,700000,6022,6066,6668,44,141.64,1614143.0049603174,5089136.37
5443,16,1000000,6022,6046,7703,24,141.64,2465023.1840707962,5089136.37
5444,2,890000,6022,6037,6529,15,141.64,2989003.2716499544,5089136.37
5445,17,700000,6022,6049,7941,27,141.64,1614143.0049603174,5089136.37
5446,2,850000,6023,6046,6372,23,141.64,2989003.2716499544,5089136.37
5447,11,1200000,6023,6052,6774,29,141.64,1820371.57,5089136.37
5448,11,900000,6023,6052,7724,29,141.64,1820371.57,5089136.37
5449,17,511760,6024,6547,8285,523,141.64,1614143.0049603174,5089136.37
5450,2,651290,6024,6030,7715,6,141.64,2989003.2716499544,5089136.37
5451,11,750000,6024,6052,6576,28,141.64,1820371.57,5089136.37
5452,21,4000000,6025,6029,6351,4,141.64,17091199.984,5089136.37
5453,12,800000,6025,6052,7151,27,141.64,7658937.101338432,5089136.37
5454,17,650000,6028,6057,6520,29,141.64,1614143.0049603174,5089136.37
5455,24,2000000,6028,6109,6701,81,141.64,23456062.532786883,5089136.37
5456,13,900000,6028,6081,8712,53,141.64,7795654.71978022,5089136.37
5457,2,900000,6029,6049,6715,20,141.64,2989003.2716499544,5089136.37
5458,3,4000000,6029,6101,6354,72,141.64,9246769.549865229,5089136.37
5459,17,1500000,6030,6056,7820,26,141.64,1614143.0049603174,5089136.37
5460,2,568280,6032,6067,7697,35,141.64,2989003.2716499544,5089136.37
5461,2,573720,6032,6086,7697,54,141.64,2989003.2716499544,5089136.37
5462,17,725000,6032,6072,7957,40,141.64,1614143.0049603174,5089136.37
5463,5,600000,6035,6053,7682,18,141.64,1400922.5020242915,5089136.37
5464,17,763000,6035,6127,6604,92,141.64,1614143.0049603174,5089136.37
5465,2,1160000,6035,6050,7347,15,141.64,2989003.2716499544,5089136.37
5466,12,600000,6035,6086,6934,51,141.64,7658937.101338432,5089136.37
5467,1,650000,6035,6045,6463,10,141.64,3325419.7044334975,5089136.37
5468,11,1680000,6035,6049,8753,14,141.64,1820371.57,5089136.37
5469,2,600000,6037,6079,6868,42,141.64,2989003.2716499544,5089136.37
5470,17,2400000,6037,7226,7834,1189,141.64,1614143.0049603174,5089136.37
5471,16,600000,6042,6120,7136,78,141.64,2465023.1840707962,5089136.37
5472,12,900000,6042,6086,7621,44,141.64,7658937.101338432,5089136.37
5473,16,600000,6043,6093,6675,50,141.64,2465023.1840707962,5089136.37
5474,11,1250000,6043,6080,7298,37,141.64,1820371.57,5089136.37
5475,3,1000000,6043,6144,7270,101,141.64,9246769.549865229,5089136.37
5476,15,800000,6043,6113,7197,70,141.64,4522577.48037889,5089136.37
5477,8,560000,6044,6255,6823,211,141.64,1501617.2191780822,5089136.37
5478,8,550000,6044,6261,6823,217,141.64,1501617.2191780822,5089136.37
5479,11,581730,6046,6067,6841,21,141.64,1820371.57,5089136.37
5480,11,900000,6046,6114,8188,68,141.64,1820371.57,5089136.37
5481,2,847985,6049,6128,6745,79,141.64,2989003.2716499544,5089136.37
5482,17,544600,6049,6101,6948,52,141.64,1614143.0049603174,5089136.37
5483,2,1000000,6049,6066,6651,17,141.64,2989003.2716499544,5089136.37
5484,2,942983,6050,6129,8438,79,141.64,2989003.2716499544,5089136.37
5485,23,2700000,6050,6668,8325,618,141.64,5772926.70157068,5089136.37
5486,11,850000,6051,6074,7178,23,141.64,1820371.57,5089136.37
5487,16,750000,6051,6067,7960,16,141.64,2465023.1840707962,5089136.37
5488,3,1750000,6052,6067,8418,15,141.64,9246769.549865229,5089136.37
5489,12,1000000,6052,6095,7333,43,141.64,7658937.101338432,5089136.37
5490,1,666750,6052,6100,8342,48,141.64,3325419.7044334975,5089136.37
5491,17,1068200,6052,6081,6962,29,141.64,1614143.0049603174,5089136.37
5492,17,550000,6052,6071,6577,19,141.64,1614143.0049603174,5089136.37
5493,19,820000,6053,6119,6744,66,141.64,6721340.5708154505,5089136.37
5494,11,600000,6056,6109,6724,53,141.64,1820371.57,5089136.37
5495,2,778960,6057,6087,6639,30,141.64,2989003.2716499544,5089136.37
5496,13,15000000,6057,6794,7618,737,141.64,7795654.71978022,5089136.37
5497,17,650000,6059,6099,6683,40,141.64,1614143.0049603174,5089136.37
5498,23,800000,6059,6121,6575,62,141.64,5772926.70157068,5089136.37
5499,17,750000,6059,6091,7015,32,141.64,1614143.0049603174,5089136.37
5500,18,700000,6059,6079,6745,20,141.64,8584355.493548388,5089136.37
5501,3,2400000,6063,6091,6312,28,141.64,9246769.549865229,5089136.37
5502,2,863500,6064,6107,6597,43,141.64,2989003.2716499544,5089136.37
5503,19,940000,6064,6080,8053,16,141.64,6721340.5708154505,5089136.37
5504,4,600000,6064,6119,7040,55,141.64,4297914.794871795,5089136.37
5505,2,650000,6066,6087,6620,21,141.64,2989003.2716499544,5089136.37
5506,17,595140,6066,6081,8317,15,141.64,1614143.0049603174,5089136.37
5507,2,865000,6066,6081,8010,15,141.64,2989003.2716499544,5089136.37
5508,2,3000000,6066,6371,7337,305,141.64,2989003.2716499544,5089136.37
5509,11,975000,6066,6081,6820,15,141.64,1820371.57,5089136.37
5510,1,791515,6066,6100,7674,34,141.64,3325419.7044334975,5089136.37
5511,2,900000,6067,6085,6638,18,141.64,2989003.2716499544,5089136.37
5512,6,800000,6067,6130,6829,63,141.64,1124713.2781954887,5089136.37
5513,2,809800,6067,6133,6729,66,141.64,2989003.2716499544,5089136.37
5514,23,550000,6067,6091,6588,24,141.64,5772926.70157068,5089136.37
5515,2,750000,6070,6214,6787,144,141.64,2989003.2716499544,5089136.37
5516,2,650000,6071,6143,6865,72,141.64,2989003.2716499544,5089136.37
5517,2,650000,6071,6143,7561,72,141.64,2989003.2716499544,5089136.37
5518,2,790000,6071,6143,6865,72,141.64,2989003.2716499544,5089136.37
5519,11,900000,6071,6088,6787,17,141.64,1820371.57,5089136.37
5520,18,830000,6072,6101,6741,29,141.64,8584355.493548388,5089136.37
5521,11,1102260,6072,6098,8564,26,141.64,1820371.57,5089136.37
5522,11,743000,6072,6332,7521,260,141.64,1820371.57,5089136.37
5523,11,939500,6072,6297,7521,225,141.64,1820371.57,5089136.37
5524,2,650000,6073,6101,6501,28,141.64,2989003.2716499544,5089136.37
5525,11,677000,6073,6312,7521,239,141.64,1820371.57,5089136.37
5526,2,800000,6073,6098,7562,25,141.64,2989003.2716499544,5089136.37
5527,18,35000000,6073,6767,7738,694,141.64,8584355.493548388,5089136.37
5528,15,600000,6073,6092,6806,19,141.64,4522577.48037889,5089136.37
5529,2,890000,6074,6115,6751,41,141.64,2989003.2716499544,5089136.37
5530,24,120000000,6074,6693,7731,619,141.64,23456062.532786883,5089136.37
5531,2,600000,6074,6107,6604,33,141.64,2989003.2716499544,5089136.37
5532,17,952640,6078,6107,7150,29,141.64,1614143.0049603174,5089136.37
5533,1,600000,6079,6133,7605,54,141.64,3325419.7044334975,5089136.37
5534,21,3000000,6079,6108,6407,29,141.64,17091199.984,5089136.37
5535,2,780420,6080,6092,7452,12,141.64,2989003.2716499544,5089136.37
5536,11,1000000,6080,6218,7368,138,141.64,1820371.57,5089136.37
5537,2,650000,6080,6185,7124,105,141.64,2989003.2716499544,5089136.37
5538,0,650000,6084,6101,6597,17,141.64,8418173.322222222,5089136.37
5539,19,630000,6085,6114,6634,29,141.64,6721340.5708154505,5089136.37
5540,11,1000000,6085,6218,7368,133,141.64,1820371.57,5089136.37
5541,11,893065,6086,6193,6729,107,141.64,1820371.57,5089136.37
5542,24,35000000,6086,6625,8097,539,141.64,23456062.532786883,5089136.37
5543,17,625420,6087,6112,6634,25,141.64,1614143.0049603174,5089136.37
5544,17,600000,6087,6100,6708,13,141.64,1614143.0049603174,5089136.37
5545,16,820000,6087,6171,6751,84,141.64,2465023.1840707962,5089136.37
5546,23,600000,6087,6101,6813,14,141.64,5772926.70157068,5089136.37
5547,1,1200000,6087,6203,7135,116,141.64,3325419.7044334975,5089136.37
5548,2,797000,6088,6134,6799,46,141.64,2989003.2716499544,5089136.37
5549,2,789420,6091,6238,6854,147,141.64,2989003.2716499544,5089136.37
5550,17,555740,6092,6144,6730,52,141.64,1614143.0049603174,5089136.37
5551,4,700000,6092,6186,7164,94,141.64,4297914.794871795,5089136.37
5552,2,1000000,6092,6123,8716,31,141.64,2989003.2716499544,5089136.37
5553,11,1210000,6092,6171,8094,79,141.64,1820371.57,5089136.37
5554,11,1000000,6093,6109,7317,16,141.64,1820371.57,5089136.37
5555,17,600700,6093,6140,6729,47,141.64,1614143.0049603174,5089136.37
5556,11,1000000,6094,6218,7368,124,141.64,1820371.57,5089136.37
5557,11,1000000,6094,6218,7368,124,141.64,1820371.57,5089136.37
5558,2,1000000,6098,6126,6616,28,141.64,2989003.2716499544,5089136.37
5559,21,70000000,6098,6484,7305,386,141.64,17091199.984,5089136.37
5560,1,650000,6098,6113,6795,15,141.64,3325419.7044334975,5089136.37
5561,5,720000,6098,6315,7499,217,141.64,1400922.5020242915,5089136.37
5562,2,1000000,6099,6150,6702,51,141.64,2989003.2716499544,5089136.37
5563,17,775000,6099,6119,6721,20,141.64,1614143.0049603174,5089136.37
5564,11,894203,6099,6218,7382,119,141.64,1820371.57,5089136.37
5565,11,600000,6099,6127,6883,28,141.64,1820371.57,5089136.37
5566,3,2300000,6100,6311,6795,211,141.64,9246769.549865229,5089136.37
5567,18,1000000,6100,6128,7432,28,141.64,8584355.493548388,5089136.37
5568,17,800000,6101,6122,6450,21,141.64,1614143.0049603174,5089136.37
5569,2,600000,6101,6254,6857,153,141.64,2989003.2716499544,5089136.37
5570,16,800000,6101,6114,6924,13,141.64,2465023.1840707962,5089136.37
5571,21,1000000,6102,6119,6983,17,141.64,17091199.984,5089136.37
5572,20,3500000,6102,6212,8157,110,141.64,7597088.421768707,5089136.37
5573,1,781350,6102,6123,6857,21,141.64,3325419.7044334975,5089136.37
5574,18,700000,6102,6136,7834,34,141.64,8584355.493548388,5089136.37
5575,17,648940,6105,6141,6536,36,141.64,1614143.0049603174,5089136.37
5576,17,1000000,6105,6140,6562,35,141.64,1614143.0049603174,5089136.37
5577,2,720000,6105,6246,6644,141,141.64,2989003.2716499544,5089136.37
5578,17,2000000,6106,6122,7179,16,141.64,1614143.0049603174,5089136.37
5579,18,780000,6106,6137,6961,31,141.64,8584355.493548388,5089136.37
5580,17,714060,6106,6343,6974,237,141.64,1614143.0049603174,5089136.37
5581,6,3100000,6106,6333,8919,227,141.64,1124713.2781954887,5089136.37
5582,18,1300000,6107,6199,6770,92,141.64,8584355.493548388,5089136.37
5583,11,894203,6107,6218,7368,111,141.64,1820371.57,5089136.37
5584,15,600000,6108,6127,7365,19,141.64,4522577.48037889,5089136.37
5585,2,995000,6112,6129,6506,17,141.64,2989003.2716499544,5089136.37
5586,22,660000,6113,6134,6619,21,141.64,2904103.2512077293,5089136.37
5587,17,774080,6113,6192,7092,79,141.64,1614143.0049603174,5089136.37
5588,24,850000,6114,6130,7724,16,141.64,23456062.532786883,5089136.37
5589,16,750000,6114,6140,6640,26,141.64,2465023.1840707962,5089136.37
5590,11,852295,6114,6218,7368,104,141.64,1820371.57,5089136.37
5591,11,600000,6115,6134,7261,19,141.64,1820371.57,5089136.37
5592,12,600000,6119,6183,6835,64,141.64,7658937.101338432,5089136.37
5593,18,1000000,6120,6133,6648,13,141.64,8584355.493548388,5089136.37
5594,2,960000,6120,6186,7697,66,141.64,2989003.2716499544,5089136.37
5595,2,885000,6121,6189,6448,68,141.64,2989003.2716499544,5089136.37
5596,1,1100000,6122,6144,7305,22,141.64,3325419.7044334975,5089136.37
5597,15,650000,6122,6186,7019,64,141.64,4522577.48037889,5089136.37
5598,5,1000000,6123,6319,7989,196,141.64,1400922.5020242915,5089136.37
5599,18,800000,6123,6162,6855,39,141.64,8584355.493548388,5089136.37
5600,2,750000,6123,6185,6466,62,141.64,2989003.2716499544,5089136.37
5601,2,980000,6123,6143,6633,20,141.64,2989003.2716499544,5089136.37
5602,11,935000,6126,6143,6700,17,141.64,1820371.57,5089136.37
5603,17,800000,6126,6164,6380,38,141.64,1614143.0049603174,5089136.37
5604,11,1000000,6126,6155,6563,29,141.64,1820371.57,5089136.37
5605,11,852295,6126,6218,7368,92,141.64,1820371.57,5089136.37
5606,13,1800000,6126,6134,6424,8,141.64,7795654.71978022,5089136.37
5607,11,1000000,6126,6151,6854,25,141.64,1820371.57,5089136.37
5608,1,1285600,6127,6168,6857,41,141.64,3325419.7044334975,5089136.37
5609,17,600000,6127,6143,6588,16,141.64,1614143.0049603174,5089136.37
5610,17,600000,6127,6175,6681,48,141.64,1614143.0049603174,5089136.37
5611,11,1200000,6127,6157,7057,30,141.64,1820371.57,5089136.37
5612,11,865000,6127,6225,7382,98,141.64,1820371.57,5089136.37
5613,17,1200000,6128,6151,7092,23,141.64,1614143.0049603174,5089136.37
5614,2,784000,6128,6422,6963,294,141.64,2989003.2716499544,5089136.37
5615,17,732880,6129,6198,6721,69,141.64,1614143.0049603174,5089136.37
5616,17,732880,6129,6218,6721,89,141.64,1614143.0049603174,5089136.37
5617,17,815680,6129,6172,7568,43,141.64,1614143.0049603174,5089136.37
5618,2,700000,6130,6204,6903,74,141.64,2989003.2716499544,5089136.37
5619,19,693245,6133,6162,8391,29,141.64,6721340.5708154505,5089136.37
5620,2,856000,6134,6200,8821,66,141.64,2989003.2716499544,5089136.37
5621,5,1100000,6134,6191,6480,57,141.64,1400922.5020242915,5089136.37
5622,14,900000,6134,6221,7254,87,141.64,5826416.914893617,5089136.37
5623,17,650000,6134,6151,7690,17,141.64,1614143.0049603174,5089136.37
5624,11,1414315,6135,6157,8328,22,141.64,1820371.57,5089136.37
5625,10,600000,6135,6246,7817,111,141.64,8282326.220930233,5089136.37
5626,10,650000,6135,6246,7820,111,141.64,8282326.220930233,5089136.37
5627,2,919840,6135,6155,6634,20,141.64,2989003.2716499544,5089136.37
5628,2,622820,6135,6178,6625,43,141.64,2989003.2716499544,5089136.37
5629,18,825000,6136,6168,6919,32,141.64,8584355.493548388,5089136.37
5630,2,1000000,6137,6156,6858,19,141.64,2989003.2716499544,5089136.37
5631,2,640000,6137,6170,6506,33,141.64,2989003.2716499544,5089136.37
5632,4,750000,6138,6170,7824,32,141.64,4297914.794871795,5089136.37
5633,13,800000,6140,6185,8006,45,141.64,7795654.71978022,5089136.37
5634,16,750000,6141,6199,6676,58,141.64,2465023.1840707962,5089136.37
5635,2,995285,6142,6239,7347,97,141.64,2989003.2716499544,5089136.37
5636,2,800000,6142,6266,6987,124,141.64,2989003.2716499544,5089136.37
5637,2,700000,6142,6172,6631,30,141.64,2989003.2716499544,5089136.37
5638,2,890000,6143,6183,7066,40,141.64,2989003.2716499544,5089136.37
5639,15,1500000,6144,6177,6469,33,141.64,4522577.48037889,5089136.37
5640,17,800000,6148,6172,6771,24,141.64,1614143.0049603174,5089136.37
5641,15,700000,6149,6197,6549,48,141.64,4522577.48037889,5089136.37
5642,18,782080,6150,6158,6584,8,141.64,8584355.493548388,5089136.37
5643,2,700000,6151,6165,6689,14,141.64,2989003.2716499544,5089136.37
5644,2,1000000,6154,6185,6569,31,141.64,2989003.2716499544,5089136.37
5645,18,800000,6155,6366,8565,211,141.64,8584355.493548388,5089136.37
5646,2,900000,6156,6207,7635,51,141.64,2989003.2716499544,5089136.37
5647,15,600000,6156,6190,7682,34,141.64,4522577.48037889,5089136.37
5648,1,750000,6157,6178,7106,21,141.64,3325419.7044334975,5089136.37
5649,2,808550,6157,6221,7878,64,141.64,2989003.2716499544,5089136.37
5650,15,900000,6157,6172,7368,15,141.64,4522577.48037889,5089136.37
5651,1,600000,6157,6176,6501,19,141.64,3325419.7044334975,5089136.37
5652,18,800000,6158,6179,6673,21,141.64,8584355.493548388,5089136.37
5653,18,1000000,6161,6361,8478,200,141.64,8584355.493548388,5089136.37
5654,2,980420,6162,6196,6764,34,141.64,2989003.2716499544,5089136.37
5655,2,862905,6162,6185,6816,23,141.64,2989003.2716499544,5089136.37
5656,11,1000000,6163,6199,6675,36,141.64,1820371.57,5089136.37
5657,11,1027275,6163,6214,6868,51,141.64,1820371.57,5089136.37
5658,2,815520,6164,6326,7463,162,141.64,2989003.2716499544,5089136.37
5659,17,1052040,6164,6339,6876,175,141.64,1614143.0049603174,5089136.37
5660,2,850000,6165,6193,7506,28,141.64,2989003.2716499544,5089136.37
5661,17,750000,6165,6196,6750,31,141.64,1614143.0049603174,5089136.37
5662,24,6000000,6165,6224,6988,59,141.64,23456062.532786883,5089136.37
5663,12,700000,6168,6199,6512,31,141.64,7658937.101338432,5089136.37
5664,18,1117615,6168,6185,6773,17,141.64,8584355.493548388,5089136.37
5665,21,56000000,6170,7632,7921,1462,141.64,17091199.984,5089136.37
5666,3,2000000,6171,6199,6354,28,141.64,9246769.549865229,5089136.37
5667,17,650000,6171,6448,7201,277,141.64,1614143.0049603174,5089136.37
5668,11,1000000,6172,6232,7288,60,141.64,1820371.57,5089136.37
5669,2,899185,6172,6206,8087,34,141.64,2989003.2716499544,5089136.37
5670,13,3000000,6173,6204,7380,31,141.64,7795654.71978022,5089136.37
5671,11,795000,6175,6198,6637,23,141.64,1820371.57,5089136.37
5672,18,1000000,6175,6193,6954,18,141.64,8584355.493548388,5089136.37
5673,17,900000,6175,6190,6928,15,141.64,1614143.0049603174,5089136.37
5674,2,789190,6176,6245,7758,69,141.64,2989003.2716499544,5089136.37
5675,17,772000,6176,6218,7060,42,141.64,1614143.0049603174,5089136.37
5676,2,950000,6177,6219,6700,42,141.64,2989003.2716499544,5089136.37
5677,2,1130160,6177,6256,7668,79,141.64,2989003.2716499544,5089136.37
5678,16,800000,6177,6193,6620,16,141.64,2465023.1840707962,5089136.37
5679,2,690000,6178,6192,6494,14,141.64,2989003.2716499544,5089136.37
5680,15,756000,6178,6211,6606,33,141.64,4522577.48037889,5089136.37
5681,2,800570,6178,6238,7185,60,141.64,2989003.2716499544,5089136.37
5682,24,600000,6179,6213,6603,34,141.64,23456062.532786883,5089136.37
5683,24,2200000,6183,6192,6367,9,141.64,23456062.532786883,5089136.37
5684,17,600720,6183,6409,7122,226,141.64,1614143.0049603174,5089136.37
5685,2,800000,6183,6198,6696,15,141.64,2989003.2716499544,5089136.37
5686,13,650000,6184,6274,6819,90,141.64,7795654.71978022,5089136.37
5687,11,1093275,6184,6402,7025,218,141.64,1820371.57,5089136.37
5688,11,650000,6184,6199,7390,15,141.64,1820371.57,5089136.37
5689,22,700000,6185,6238,6630,53,141.64,2904103.2512077293,5089136.37
5690,2,838240,6185,6199,6722,14,141.64,2989003.2716499544,5089136.37
5691,1,700000,6186,6228,6616,42,141.64,3325419.7044334975,5089136.37
5692,22,700000,6186,6238,6630,52,141.64,2904103.2512077293,5089136.37
5693,2,899260,6189,6206,6732,17,141.64,2989003.2716499544,5089136.37
5694,2,950000,6189,6611,7575,422,141.64,2989003.2716499544,5089136.37
5695,3,1000000,6189,6234,6617,45,141.64,9246769.549865229,5089136.37
5696,17,700000,6189,6252,6717,63,141.64,1614143.0049603174,5089136.37
5697,17,700000,6189,6252,6717,63,141.64,1614143.0049603174,5089136.37
5698,11,750000,6190,6210,6618,20,141.64,1820371.57,5089136.37
5699,1,534020,6190,6212,7107,22,141.64,3325419.7044334975,5089136.37
5700,2,615890,6191,6330,7103,139,141.64,2989003.2716499544,5089136.37
5701,18,600000,6191,6213,6703,22,141.64,8584355.493548388,5089136.37
5702,17,1089560,6191,6224,7628,33,141.64,1614143.0049603174,5089136.37
5703,22,650000,6191,6211,7229,20,141.64,2904103.2512077293,5089136.37
5704,11,1000000,6192,6219,8320,27,141.64,1820371.57,5089136.37
5705,2,785000,6192,6212,6819,20,141.64,2989003.2716499544,5089136.37
5706,2,945320,6193,6260,8915,67,141.64,2989003.2716499544,5089136.37
5707,11,1000000,6193,6221,6815,28,141.64,1820371.57,5089136.37
5708,17,676140,6196,6422,6723,226,141.64,1614143.0049603174,5089136.37
5709,11,1000000,6196,6235,7838,39,141.64,1820371.57,5089136.37
5710,1,777505,6198,6218,6921,20,141.64,3325419.7044334975,5089136.37
5711,15,1000000,6198,6438,7255,240,141.64,4522577.48037889,5089136.37
5712,2,753510,6199,6221,7844,22,141.64,2989003.2716499544,5089136.37
5713,17,788770,6199,6218,6613,19,141.64,1614143.0049603174,5089136.37
5714,16,650000,6200,6218,7838,18,141.64,2465023.1840707962,5089136.37
5715,3,2600000,6200,6238,6576,38,141.64,9246769.549865229,5089136.37
5716,17,970000,6203,6226,7015,23,141.64,1614143.0049603174,5089136.37
5717,17,800000,6203,6242,7523,39,141.64,1614143.0049603174,5089136.37
5718,11,1000000,6203,6450,8703,247,141.64,1820371.57,5089136.37
5719,16,800000,6203,6253,7355,50,141.64,2465023.1840707962,5089136.37
5720,17,919740,6203,6246,6856,43,141.64,1614143.0049603174,5089136.37
5721,11,1450000,6204,6218,7137,14,141.64,1820371.57,5089136.37
5722,1,726925,6204,6221,6875,17,141.64,3325419.7044334975,5089136.37
5723,17,1000000,6205,6213,6545,8,141.64,1614143.0049603174,5089136.37
5724,11,838920,6206,6281,7002,75,141.64,1820371.57,5089136.37
5725,1,579860,6206,6239,6757,33,141.64,3325419.7044334975,5089136.37
5726,1,993140,6211,6231,6947,20,141.64,3325419.7044334975,5089136.37
5727,21,5000000,6211,6345,7920,134,141.64,17091199.984,5089136.37
5728,18,804960,6211,6233,8451,22,141.64,8584355.493548388,5089136.37
5729,17,570000,6211,6261,7004,50,141.64,1614143.0049603174,5089136.37
5730,1,700000,6212,6255,7162,43,141.64,3325419.7044334975,5089136.37
5731,5,600000,6213,6289,7402,76,141.64,1400922.5020242915,5089136.37
5732,16,2300000,6213,6238,8901,25,141.64,2465023.1840707962,5089136.37
5733,22,1000000,6220,6409,6724,189,141.64,2904103.2512077293,5089136.37
5734,17,605000,6220,6232,6336,12,141.64,1614143.0049603174,5089136.37
5735,17,750000,6221,6239,6816,18,141.64,1614143.0049603174,5089136.37
5736,12,1000000,6221,6235,8158,14,141.64,7658937.101338432,5089136.37
5737,12,2000000,6221,6274,7585,53,141.64,7658937.101338432,5089136.37
5738,2,632220,6224,6254,7730,30,141.64,2989003.2716499544,5089136.37
5739,1,766050,6224,6256,6764,32,141.64,3325419.7044334975,5089136.37
5740,2,743200,6225,6310,6815,85,141.64,2989003.2716499544,5089136.37
5741,18,1593000,6225,6379,7362,154,141.64,8584355.493548388,5089136.37
5742,21,650000,6225,6239,6511,14,141.64,17091199.984,5089136.37
5743,2,795540,6225,6256,6959,31,141.64,2989003.2716499544,5089136.37
5744,11,529595,6225,6281,6840,56,141.64,1820371.57,5089136.37
5745,2,650000,6226,6246,8013,20,141.64,2989003.2716499544,5089136.37
5746,2,827750,6226,6273,6774,47,141.64,2989003.2716499544,5089136.37
5747,23,1800000,6226,6246,7372,20,141.64,5772926.70157068,5089136.37
5748,11,3000000,6227,6317,8060,90,141.64,1820371.57,5089136.37
5749,17,616800,6228,6287,7277,59,141.64,1614143.0049603174,5089136.37
5750,21,1040000,6231,6246,7120,15,141.64,17091199.984,5089136.37
5751,11,1000000,6231,6281,7705,50,141.64,1820371.57,5089136.37
5752,2,820400,6231,6252,6682,21,141.64,2989003.2716499544,5089136.37
5753,2,839080,6232,6242,6668,10,141.64,2989003.2716499544,5089136.37
5754,0,14500000,6232,6277,8509,45,141.64,8418173.322222222,5089136.37
5755,11,700000,6233,6280,6823,47,141.64,1820371.57,5089136.37
5756,12,2000000,6234,6270,7995,36,141.64,7658937.101338432,5089136.37
5757,1,825000,6234,6273,6779,39,141.64,3325419.7044334975,5089136.37
5758,19,838775,6235,6275,7347,40,141.64,6721340.5708154505,5089136.37
5759,17,1000000,6235,6289,7310,54,141.64,1614143.0049603174,5089136.37
5760,2,840000,6235,6266,6738,31,141.64,2989003.2716499544,5089136.37
5761,17,836500,6241,6359,7338,118,141.64,1614143.0049603174,5089136.37
5762,17,600000,6242,6276,6876,34,141.64,1614143.0049603174,5089136.37
5763,2,818840,6242,6415,7313,173,141.64,2989003.2716499544,5089136.37
5764,16,1000000,6242,6261,7221,19,141.64,2465023.1840707962,5089136.37
5765,17,975000,6245,6308,7086,63,141.64,1614143.0049603174,5089136.37
5766,2,948200,6246,6262,7424,16,141.64,2989003.2716499544,5089136.37
5767,1,740000,6246,6361,6715,115,141.64,3325419.7044334975,5089136.37
5768,17,600000,6247,6288,7158,41,141.64,1614143.0049603174,5089136.37
5769,2,968420,6247,6357,6595,110,141.64,2989003.2716499544,5089136.37
5770,5,733000,6248,6359,6856,111,141.64,1400922.5020242915,5089136.37
5771,16,1328520,6253,6290,8885,37,141.64,2465023.1840707962,5089136.37
5772,16,680000,6253,6276,6695,23,141.64,2465023.1840707962,5089136.37
5773,12,1000000,6255,6270,7172,15,141.64,7658937.101338432,5089136.37
5774,2,750000,6255,6393,6974,138,141.64,2989003.2716499544,5089136.37
5775,23,30000000,6256,7002,7830,746,141.64,5772926.70157068,5089136.37
5776,5,734600,6256,6275,7150,19,141.64,1400922.5020242915,5089136.37
5777,2,700000,6256,6277,6969,21,141.64,2989003.2716499544,5089136.37
5778,17,560000,6256,6359,8054,103,141.64,1614143.0049603174,5089136.37
5779,18,806815,6256,6375,6749,119,141.64,8584355.493548388,5089136.37
5780,17,850000,6259,6274,6745,15,141.64,1614143.0049603174,5089136.37
5781,18,1110235,6259,6273,6912,14,141.64,8584355.493548388,5089136.37
5782,2,740000,6260,6283,7310,23,141.64,2989003.2716499544,5089136.37
5783,1,650000,6262,6402,8117,140,141.64,3325419.7044334975,5089136.37
5784,1,550000,6262,6422,8751,160,141.64,3325419.7044334975,5089136.37
5785,1,700000,6262,6287,7620,25,141.64,3325419.7044334975,5089136.37
5786,2,671860,6263,6312,7738,49,141.64,2989003.2716499544,5089136.37
5787,2,1081580,6266,6459,7858,193,141.64,2989003.2716499544,5089136.37
5788,17,575000,6266,6311,6879,45,141.64,1614143.0049603174,5089136.37
5789,12,1600000,6268,6284,7466,16,141.64,7658937.101338432,5089136.37
5790,16,800000,6270,6284,6522,14,141.64,2465023.1840707962,5089136.37
5791,2,1300000,6273,6351,6947,78,141.64,2989003.2716499544,5089136.37
5792,2,508900,6274,6512,6884,238,141.64,2989003.2716499544,5089136.37
5793,2,508900,6274,6508,6884,234,141.64,2989003.2716499544,5089136.37
5794,17,550000,6277,6338,7151,61,141.64,1614143.0049603174,5089136.37
5795,16,650000,6277,6322,7323,45,141.64,2465023.1840707962,5089136.37
5796,17,600000,6281,6329,8369,48,141.64,1614143.0049603174,5089136.37
5797,4,1100000,6282,6352,7221,70,141.64,4297914.794871795,5089136.37
5798,2,600000,6282,6337,6856,55,141.64,2989003.2716499544,5089136.37
5799,2,900000,6282,6325,6997,43,141.64,2989003.2716499544,5089136.37
5800,2,673082,6282,6316,6637,34,141.64,2989003.2716499544,5089136.37
5801,1,740900,6283,6304,7738,21,141.64,3325419.7044334975,5089136.37
5802,6,568000,6283,6315,8537,32,141.64,1124713.2781954887,5089136.37
5803,2,700000,6284,6311,7499,27,141.64,2989003.2716499544,5089136.37
5804,1,883000,6284,6330,7019,46,141.64,3325419.7044334975,5089136.37
5805,18,950000,6284,6368,7170,84,141.64,8584355.493548388,5089136.37
5806,24,50000000,6287,7089,8867,802,141.64,23456062.532786883,5089136.37
5807,11,800000,6287,6407,6925,120,141.64,1820371.57,5089136.37
5808,19,800000,6287,6506,6855,219,141.64,6721340.5708154505,5089136.37
5809,18,44500000,6287,7010,7870,723,141.64,8584355.493548388,5089136.37
5810,17,612080,6287,6371,7821,84,141.64,1614143.0049603174,5089136.37
5811,1,739360,6288,6308,6961,20,141.64,3325419.7044334975,5089136.37
5812,15,600000,6288,6322,7817,34,141.64,4522577.48037889,5089136.37
5813,2,150000000,6288,7107,8254,819,141.64,2989003.2716499544,5089136.37
5814,24,60000000,6289,6675,7838,386,141.64,23456062.532786883,5089136.37
5815,18,5000000,6289,7282,7698,993,141.64,8584355.493548388,5089136.37
5816,18,5000000,6289,7198,7698,909,141.64,8584355.493548388,5089136.37
5817,6,5330000,6289,7501,8242,1212,141.64,1124713.2781954887,5089136.37
5818,11,522565,6290,6359,7127,69,141.64,1820371.57,5089136.37
5819,1,600000,6290,6345,7249,55,141.64,3325419.7044334975,5089136.37
5820,21,73000000,6290,7551,8269,1261,141.64,17091199.984,5089136.37
5821,19,50000000,6291,7334,7684,1043,141.64,6721340.5708154505,5089136.37
5822,19,50000000,6291,7334,7684,1043,141.64,6721340.5708154505,5089136.37
5823,19,33000000,6291,7333,7689,1042,141.64,6721340.5708154505,5089136.37
5824,15,80000000,6291,7117,8326,826,141.64,4522577.48037889,5089136.37
5825,17,1025000,6291,6336,6967,45,141.64,1614143.0049603174,5089136.37
5826,19,666470,6295,6352,6841,57,141.64,6721340.5708154505,5089136.37
5827,3,2000000,6296,6382,7306,86,141.64,9246769.549865229,5089136.37
5828,13,1800000,6296,6988,7606,692,141.64,7795654.71978022,5089136.37
5829,11,1374400,6296,6331,7722,35,141.64,1820371.57,5089136.37
5830,2,800000,6297,6325,6723,28,141.64,2989003.2716499544,5089136.37
5831,2,610000,6297,6374,7172,77,141.64,2989003.2716499544,5089136.37
5832,1,700000,6298,6415,8325,117,141.64,3325419.7044334975,5089136.37
5833,22,900000,6303,6388,7365,85,170.53,2904103.2512077293,5237438.95
5834,12,1000000,6304,6329,6989,25,170.53,7658937.101338432,5237438.95
5835,11,1000000,6308,6339,7792,31,170.53,1820371.57,5237438.95
5836,2,900000,6308,6345,6717,37,170.53,2989003.2716499544,5237438.95
5837,2,1141600,6308,6364,7516,56,170.53,2989003.2716499544,5237438.95
5838,16,600000,6309,6347,6969,38,170.53,2465023.1840707962,5237438.95
5839,16,800000,6309,6400,6959,91,170.53,2465023.1840707962,5237438.95
5840,17,661310,6316,6380,6772,64,170.53,1614143.0049603174,5237438.95
5841,17,700000,6318,6373,6645,55,170.53,1614143.0049603174,5237438.95
5842,21,1200000,6318,6339,6576,21,170.53,17091199.984,5237438.95
5843,2,566040,6319,7011,8662,692,170.53,2989003.2716499544,5237438.95
5844,15,800000,6322,6339,6953,17,170.53,4522577.48037889,5237438.95
5845,2,1003420,6323,6354,7737,31,170.53,2989003.2716499544,5237438.95
5846,4,600000,6324,6365,7045,41,170.53,4297914.794871795,5237438.95
5847,17,1200000,6324,6396,7207,72,170.53,1614143.0049603174,5237438.95
5848,17,865925,6324,6352,6921,28,170.53,1614143.0049603174,5237438.95
5849,16,900000,6325,6354,6976,29,170.53,2465023.1840707962,5237438.95
5850,17,731700,6330,6470,8852,140,170.53,1614143.0049603174,5237438.95
5851,17,731700,6330,6470,8839,140,170.53,1614143.0049603174,5237438.95
5852,17,900000,6331,6359,7061,28,170.53,1614143.0049603174,5237438.95
5853,12,1000000,6333,6366,8746,33,170.53,7658937.101338432,5237438.95
5854,17,960000,6336,6415,7089,79,170.53,1614143.0049603174,5237438.95
5855,11,700000,6336,6379,6840,43,170.53,1820371.57,5237438.95
5856,1,648320,6338,6514,8297,176,170.53,3325419.7044334975,5237438.95
5857,11,1275467,6340,6556,8052,216,170.53,1820371.57,5237438.95
5858,17,787500,6340,6371,6707,31,170.53,1614143.0049603174,5237438.95
5859,15,76526000,6340,6974,8676,634,170.53,4522577.48037889,5237438.95
5860,10,2790000,6343,6448,7004,105,170.53,8282326.220930233,5237438.95
5861,17,589255,6345,6402,7606,57,170.53,1614143.0049603174,5237438.95
5862,15,700000,6345,6361,6800,16,170.53,4522577.48037889,5237438.95
5863,16,750000,6346,6359,7011,13,170.53,2465023.1840707962,5237438.95
5864,20,8000000,6346,6428,8214,82,170.53,7597088.421768707,5237438.95
5865,18,800000,6347,6389,6893,42,170.53,8584355.493548388,5237438.95
5866,2,1208660,6351,6443,7229,92,170.53,2989003.2716499544,5237438.95
5867,3,1320000,6351,6359,6673,8,170.53,9246769.549865229,5237438.95
5868,6,600000,6351,6407,6941,56,170.53,1124713.2781954887,5237438.95
5869,6,600000,6351,6410,6941,59,170.53,1124713.2781954887,5237438.95
5870,16,750000,6352,6427,8069,75,170.53,2465023.1840707962,5237438.95
5871,15,550000,6352,6366,6980,14,170.53,4522577.48037889,5237438.95
5872,16,760000,6352,6386,6730,34,170.53,2465023.1840707962,5237438.95
5873,19,847260,6353,6368,7010,15,170.53,6721340.5708154505,5237438.95
5874,1,1086700,6354,6396,6777,42,170.53,3325419.7044334975,5237438.95
5875,17,650000,6357,6408,8769,51,170.53,1614143.0049603174,5237438.95
5876,17,845050,6359,6422,8089,63,170.53,1614143.0049603174,5237438.95
5877,16,850000,6359,6387,6896,28,170.53,2465023.1840707962,5237438.95
5878,11,1107440,6361,6413,7046,52,170.53,1820371.57,5237438.95
5879,11,1200000,6361,6417,7642,56,170.53,1820371.57,5237438.95
5880,12,800000,6361,6417,7354,56,170.53,7658937.101338432,5237438.95
5881,2,900000,6361,6422,7102,61,170.53,2989003.2716499544,5237438.95
5882,2,654500,6364,6472,6960,108,170.53,2989003.2716499544,5237438.95
5883,17,2500000,6364,6420,6667,56,170.53,1614143.0049603174,5237438.95
5884,11,904760,6365,6402,7528,37,170.53,1820371.57,5237438.95
5885,18,814055,6365,6436,7830,71,170.53,8584355.493548388,5237438.95
5886,16,785000,6365,6393,7458,28,170.53,2465023.1840707962,5237438.95
5887,17,707295,6366,6401,7290,35,170.53,1614143.0049603174,5237438.95
5888,1,833995,6366,6477,7268,111,170.53,3325419.7044334975,5237438.95
5889,2,1046000,6366,6473,6940,107,170.53,2989003.2716499544,5237438.95
5890,16,600000,6367,6683,7512,316,170.53,2465023.1840707962,5237438.95
5891,11,9000000,6367,6907,7667,540,170.53,1820371.57,5237438.95
5892,11,50577000,6367,7218,7667,851,170.53,1820371.57,5237438.95
5893,16,600000,6367,6683,7512,316,170.53,2465023.1840707962,5237438.95
5894,12,1500000,6367,6392,7232,25,170.53,7658937.101338432,5237438.95
5895,15,800000,6371,6382,6653,11,170.53,4522577.48037889,5237438.95
5896,1,855610,6371,6428,7333,57,170.53,3325419.7044334975,5237438.95
5897,12,600000,6372,6568,8037,196,170.53,7658937.101338432,5237438.95
5898,17,842950,6372,6386,6771,14,170.53,1614143.0049603174,5237438.95
5899,11,1300000,6373,6414,7662,41,170.53,1820371.57,5237438.95
5900,14,525000,6374,6431,7170,57,170.53,5826416.914893617,5237438.95
5901,11,600000,6374,6410,7242,36,170.53,1820371.57,5237438.95
5902,5,650000,6375,6480,7366,105,170.53,1400922.5020242915,5237438.95
5903,2,640000,6375,6393,6799,18,170.53,2989003.2716499544,5237438.95
5904,10,600000,6379,6394,8074,15,170.53,8282326.220930233,5237438.95
5905,2,800000,6379,6399,6925,20,170.53,2989003.2716499544,5237438.95
5906,2,1100000,6380,6421,6819,41,170.53,2989003.2716499544,5237438.95
5907,15,1000000,6380,6401,6777,21,170.53,4522577.48037889,5237438.95
5908,20,3663400,6380,6402,6660,22,170.53,7597088.421768707,5237438.95
5909,11,513950,6381,6417,7059,36,170.53,1820371.57,5237438.95
5910,17,1000000,6381,6410,8034,29,170.53,1614143.0049603174,5237438.95
5911,2,1020640,6381,6450,7844,69,170.53,2989003.2716499544,5237438.95
5912,11,1011375,6382,6456,6931,74,170.53,1820371.57,5237438.95
5913,18,803540,6384,6485,7948,101,170.53,8584355.493548388,5237438.95
5914,17,550000,6385,6402,7017,17,170.53,1614143.0049603174,5237438.95
5915,21,1000000,6385,6393,6540,8,170.53,17091199.984,5237438.95
5916,15,550000,6386,6442,7249,56,170.53,4522577.48037889,5237438.95
5917,15,550000,6386,6442,7249,56,170.53,4522577.48037889,5237438.95
5918,16,600000,6387,6420,7009,33,170.53,2465023.1840707962,5237438.95
5919,1,750000,6387,6408,6969,21,170.53,3325419.7044334975,5237438.95
5920,8,1000000,6388,6513,7199,125,170.53,1501617.2191780822,5237438.95
5921,17,785870,6388,6436,7179,48,170.53,1614143.0049603174,5237438.95
5922,2,61013000,6389,6729,7310,340,170.53,2989003.2716499544,5237438.95
5923,17,1200000,6390,6421,6952,31,170.53,1614143.0049603174,5237438.95
5924,15,700000,6392,6408,7050,16,170.53,4522577.48037889,5237438.95
5925,3,800000,6392,6415,6774,23,170.53,9246769.549865229,5237438.95
5926,12,750000,6393,6604,7323,211,170.53,7658937.101338432,5237438.95
5927,8,600000,6393,6436,6969,43,170.53,1501617.2191780822,5237438.95
5928,2,1103160,6394,6822,7509,428,170.53,2989003.2716499544,5237438.95
5929,12,750000,6395,6414,7208,19,170.53,7658937.101338432,5237438.95
5930,1,866140,6396,6421,6760,25,170.53,3325419.7044334975,5237438.95
5931,17,800000,6396,6423,7822,27,170.53,1614143.0049603174,5237438.95
5932,17,600000,6398,6459,6865,61,170.53,1614143.0049603174,5237438.95
5933,16,1000000,6401,6438,8304,37,170.53,2465023.1840707962,5237438.95
5934,2,971000,6401,6506,7540,105,170.53,2989003.2716499544,5237438.95
5935,16,600000,6402,6463,7081,61,170.53,2465023.1840707962,5237438.95
5936,2,770000,6405,6434,6928,29,170.53,2989003.2716499544,5237438.95
5937,11,975820,6408,6436,7110,28,170.53,1820371.57,5237438.95
5938,5,600000,6408,6423,8675,15,170.53,1400922.5020242915,5237438.95
5939,10,600000,6409,6428,8114,19,170.53,8282326.220930233,5237438.95
5940,2,600000,6409,6423,7040,14,170.53,2989003.2716499544,5237438.95
5941,11,1010000,6409,6427,7194,18,170.53,1820371.57,5237438.95
5942,2,1032340,6409,6525,7291,116,170.53,2989003.2716499544,5237438.95
5943,16,950000,6409,6427,7743,18,170.53,2465023.1840707962,5237438.95
5944,2,851680,6409,6456,7193,47,170.53,2989003.2716499544,5237438.95
5945,16,600000,6409,6428,6932,19,170.53,2465023.1840707962,5237438.95
5946,11,1000000,6410,6448,7016,38,170.53,1820371.57,5237438.95
5947,22,550000,6410,6485,6969,75,170.53,2904103.2512077293,5237438.95
5948,7,600000,6410,6522,7773,112,170.53,3738553.685483871,5237438.95
5949,16,550000,6410,6471,6850,61,170.53,2465023.1840707962,5237438.95
5950,11,973250,6413,6429,7150,16,170.53,1820371.57,5237438.95
5951,21,1000000,6413,6436,7716,23,170.53,17091199.984,5237438.95
5952,3,4000000,6414,6462,7113,48,170.53,9246769.549865229,5237438.95
5953,12,557400,6415,6674,7064,259,170.53,7658937.101338432,5237438.95
5954,18,984000,6415,6459,6840,44,170.53,8584355.493548388,5237438.95
5955,15,900000,6416,6452,7834,36,170.53,4522577.48037889,5237438.95
5956,18,1300000,6416,6431,6876,15,170.53,8584355.493548388,5237438.95
5957,12,20000000,6416,7269,8046,853,170.53,7658937.101338432,5237438.95
5958,24,700000,6416,6435,6872,19,170.53,23456062.532786883,5237438.95
5959,24,700000,6416,6435,6906,19,170.53,23456062.532786883,5237438.95
5960,13,700000,6417,6479,6595,62,170.53,7795654.71978022,5237438.95
5961,15,600000,6417,6508,6975,91,170.53,4522577.48037889,5237438.95
5962,1,758100,6417,6434,7073,17,170.53,3325419.7044334975,5237438.95
5963,1,525000,6417,6652,7012,235,170.53,3325419.7044334975,5237438.95
5964,17,2000000,6417,6479,7703,62,170.53,1614143.0049603174,5237438.95
5965,9,752000,6417,6450,6578,33,170.53,3707403.8834951455,5237438.95
5966,15,600000,6420,6444,6988,24,170.53,4522577.48037889,5237438.95
5967,3,750000,6421,6640,7939,219,170.53,9246769.549865229,5237438.95
5968,2,794000,6422,6435,7047,13,170.53,2989003.2716499544,5237438.95
5969,15,19000000,6424,7444,7840,1020,170.53,4522577.48037889,5237438.95
5970,17,537215,6425,6462,6980,37,170.53,1614143.0049603174,5237438.95
5971,2,600000,6425,6508,7227,83,170.53,2989003.2716499544,5237438.95
5972,12,1200000,6426,6444,7332,18,170.53,7658937.101338432,5237438.95
5973,17,932780,6427,6479,6982,52,170.53,1614143.0049603174,5237438.95
5974,3,687000,6429,6455,7095,26,170.53,9246769.549865229,5237438.95
5975,6,650000,6429,6444,7205,15,170.53,1124713.2781954887,5237438.95
5976,19,1025000,6429,6494,7885,65,170.53,6721340.5708154505,5237438.95
5977,1,525000,6430,6652,7012,222,170.53,3325419.7044334975,5237438.95
5978,2,525000,6430,6452,6953,22,170.53,2989003.2716499544,5237438.95
5979,5,540000,6430,6498,7227,68,170.53,1400922.5020242915,5237438.95
5980,22,700000,6431,6445,7586,14,170.53,2904103.2512077293,5237438.95
5981,3,600000,6432,6449,6791,17,170.53,9246769.549865229,5237438.95
5982,2,700000,6432,6674,7611,242,170.53,2989003.2716499544,5237438.95
5983,2,962860,6432,6479,7449,47,170.53,2989003.2716499544,5237438.95
5984,17,900240,6432,6462,6970,30,170.53,1614143.0049603174,5237438.95
5985,18,993960,6434,6450,6819,16,170.53,8584355.493548388,5237438.95
5986,17,616660,6434,6485,7082,51,170.53,1614143.0049603174,5237438.95
5987,2,777265,6435,6464,6870,29,170.53,2989003.2716499544,5237438.95
5988,10,600000,6435,6450,6812,15,170.53,8282326.220930233,5237438.95
5989,2,600000,6436,6451,7684,15,170.53,2989003.2716499544,5237438.95
5990,15,650000,6436,6506,7157,70,170.53,4522577.48037889,5237438.95
5991,1,1175000,6436,6487,7323,51,170.53,3325419.7044334975,5237438.95
5992,5,540000,6437,6595,7165,158,170.53,1400922.5020242915,5237438.95
5993,17,790000,6437,6491,7466,54,170.53,1614143.0049603174,5237438.95
5994,2,700000,6437,6477,6953,40,170.53,2989003.2716499544,5237438.95
5995,9,1700000,6438,6466,8703,28,170.53,3707403.8834951455,5237438.95
5996,12,900000,6443,6457,7900,14,170.53,7658937.101338432,5237438.95
5997,7,1000000,6443,6886,8197,443,170.53,3738553.685483871,5237438.95
5998,22,650000,6444,6527,7660,83,170.53,2904103.2512077293,5237438.95
5999,19,1044300,6444,6477,7493,33,170.53,6721340.5708154505,5237438.95
6000,15,800000,6445,6498,8102,53,170.53,4522577.48037889,5237438.95
6001,19,700000,6445,6604,7312,159,170.53,6721340.5708154505,5237438.95
6002,14,600000,6445,6458,6991,13,170.53,5826416.914893617,5237438.95
6003,7,5000000,6447,6963,7891,516,170.53,3738553.685483871,5237438.95
6004,24,1000000,6449,6479,6494,30,170.53,23456062.532786883,5237438.95
6005,13,550000,6449,6472,7638,23,170.53,7795654.71978022,5237438.95
6006,17,650000,6449,6464,6969,15,170.53,1614143.0049603174,5237438.95
6007,18,43000000,6451,7613,8769,1162,170.53,8584355.493548388,5237438.95
6008,18,100000000,6451,7625,8776,1174,170.53,8584355.493548388,5237438.95
6009,2,900000,6451,6513,7277,62,170.53,2989003.2716499544,5237438.95
6010,3,700000,6451,6480,6795,29,170.53,9246769.549865229,5237438.95
6011,2,840150,6452,6476,7106,24,170.53,2989003.2716499544,5237438.95
6012,2,1274080,6452,6490,6933,38,170.53,2989003.2716499544,5237438.95
6013,17,900000,6452,6498,8607,46,170.53,1614143.0049603174,5237438.95
6014,15,700000,6452,6471,6948,19,170.53,4522577.48037889,5237438.95
6015,4,800000,6456,6473,7114,17,170.53,4297914.794871795,5237438.95
6016,2,1000000,6458,6477,6924,19,170.53,2989003.2716499544,5237438.95
6017,15,700000,6458,6472,7646,14,170.53,4522577.48037889,5237438.95
6018,17,740000,6459,6476,7108,17,170.53,1614143.0049603174,5237438.95
6019,11,1000000,6459,6492,7234,33,170.53,1820371.57,5237438.95
6020,12,850000,6459,6478,8361,19,170.53,7658937.101338432,5237438.95
6021,15,530000,6459,6507,7296,48,170.53,4522577.48037889,5237438.95
6022,11,855550,6462,6479,7166,17,170.53,1820371.57,5237438.95
6023,0,600000,6462,6548,7305,86,170.53,8418173.322222222,5237438.95
6024,17,600000,6463,6479,6829,16,170.53,1614143.0049603174,5237438.95
6025,15,600000,6463,6490,7015,27,170.53,4522577.48037889,5237438.95
6026,0,1100000,6464,6508,7463,44,170.53,8418173.322222222,5237438.95
6027,1,694500,6464,6498,6996,34,170.53,3325419.7044334975,5237438.95
6028,17,534000,6466,6582,7172,116,170.53,1614143.0049603174,5237438.95
6029,2,900000,6466,6484,8726,18,170.53,2989003.2716499544,5237438.95
6030,13,600000,6470,6515,7411,45,170.53,7795654.71978022,5237438.95
6031,2,900000,6471,6556,7612,85,170.53,2989003.2716499544,5237438.95
6032,19,900000,6472,6494,7176,22,170.53,6721340.5708154505,5237438.95
6033,14,650000,6472,6490,7687,18,170.53,5826416.914893617,5237438.95
6034,18,765660,6472,6539,7383,67,170.53,8584355.493548388,5237438.95
6035,22,600000,6472,6759,7814,287,170.53,2904103.2512077293,5237438.95
6036,18,765660,6472,6539,7340,67,170.53,8584355.493548388,5237438.95
6037,15,600000,6473,6512,6899,39,170.53,4522577.48037889,5237438.95
6038,3,20200000,6473,6539,7263,66,170.53,9246769.549865229,5237438.95
6039,3,1425100,6473,6539,8635,66,170.53,9246769.549865229,5237438.95
6040,24,900000,6476,6505,7299,29,170.53,23456062.532786883,5237438.95
6041,11,625000,6476,6520,7176,44,170.53,1820371.57,5237438.95
6042,11,625000,6476,6520,7176,44,170.53,1820371.57,5237438.95
6043,11,2000000,6476,6638,8149,162,170.53,1820371.57,5237438.95
6044,1,828000,6478,6576,7403,98,170.53,3325419.7044334975,5237438.95
6045,11,729500,6478,6497,6928,19,170.53,1820371.57,5237438.95
6046,16,1314750,6479,6499,7130,20,170.53,2465023.1840707962,5237438.95
6047,15,3800000,6479,6528,7933,49,170.53,4522577.48037889,5237438.95
6048,5,1500000,6484,6540,7257,56,170.53,1400922.5020242915,5237438.95
6049,19,800000,6484,6508,8129,24,170.53,6721340.5708154505,5237438.95
6050,11,817500,6484,6646,7358,162,170.53,1820371.57,5237438.95
6051,11,600000,6486,6746,7673,260,170.53,1820371.57,5237438.95
6052,15,15000000,6486,7008,8178,522,170.53,4522577.48037889,5237438.95
6053,12,999999,6487,6504,7457,17,170.53,7658937.101338432,5237438.95
6054,16,750000,6487,6695,7324,208,170.53,2465023.1840707962,5237438.95
6055,19,600000,6490,6604,7144,114,170.53,6721340.5708154505,5237438.95
6056,24,280000000,6490,6940,7794,450,170.53,23456062.532786883,5237438.95
6057,18,778780,6490,6535,7200,45,170.53,8584355.493548388,5237438.95
6058,2,650000,6491,6568,7221,77,170.53,2989003.2716499544,5237438.95
6059,11,810760,6491,6541,6988,50,170.53,1820371.57,5237438.95
6060,21,1500000,6492,6716,7516,224,170.53,17091199.984,5237438.95
6061,18,1521380,6497,6540,7209,43,170.53,8584355.493548388,5237438.95
6062,17,750000,6497,6512,7613,15,170.53,1614143.0049603174,5237438.95
6063,3,1000000,6498,6690,8005,192,170.53,9246769.549865229,5237438.95
6064,11,710000,6500,6540,7022,40,170.53,1820371.57,5237438.95
6065,17,550000,6500,6806,7565,306,170.53,1614143.0049603174,5237438.95
6066,9,700000,6500,6514,7131,14,170.53,3707403.8834951455,5237438.95
6067,15,800000,6507,6522,6959,15,170.53,4522577.48037889,5237438.95
6068,4,600000,6508,6535,7127,27,170.53,4297914.794871795,5237438.95
6069,19,550000,6508,6526,6912,18,170.53,6721340.5708154505,5237438.95
6070,2,800000,6508,6644,7366,136,170.53,2989003.2716499544,5237438.95
6071,17,990000,6508,6626,7982,118,170.53,1614143.0049603174,5237438.95
6072,16,650000,6511,6655,7590,144,170.53,2465023.1840707962,5237438.95
6073,16,10000000,6512,7516,8660,1004,170.53,2465023.1840707962,5237438.95
6074,15,750000,6512,6533,7493,21,170.53,4522577.48037889,5237438.95
6075,16,5500000,6512,7516,8660,1004,170.53,2465023.1840707962,5237438.95
6076,17,714000,6512,6536,7179,24,170.53,1614143.0049603174,5237438.95
6077,2,750000,6512,6550,7572,38,170.53,2989003.2716499544,5237438.95
6078,15,800000,6513,6529,7267,16,170.53,4522577.48037889,5237438.95
6079,15,701636,6513,6680,7248,167,170.53,4522577.48037889,5237438.95
6080,11,865185,6514,6571,8326,57,170.53,1820371.57,5237438.95
6081,21,2840000,6515,6568,7145,53,170.53,17091199.984,5237438.95
6082,15,6000000,6515,6540,8438,25,170.53,4522577.48037889,5237438.95
6083,15,665000,6516,6535,7045,19,170.53,4522577.48037889,5237438.95
6084,2,800000,6519,6574,7866,55,170.53,2989003.2716499544,5237438.95
6085,2,998280,6520,6618,7173,98,170.53,2989003.2716499544,5237438.95
6086,24,999999,6520,6609,7432,89,170.53,23456062.532786883,5237438.95
6087,11,598875,6522,6549,7275,27,170.53,1820371.57,5237438.95
6088,17,550000,6526,6577,7414,51,170.53,1614143.0049603174,5237438.95
6089,15,650000,6526,6554,7022,28,170.53,4522577.48037889,5237438.95
6090,21,800000,6527,6555,6876,28,170.53,17091199.984,5237438.95
6091,2,800000,6528,6571,7366,43,170.53,2989003.2716499544,5237438.95
6092,18,600000,6528,6567,7060,39,170.53,8584355.493548388,5237438.95
6093,16,750000,6529,6543,7162,14,170.53,2465023.1840707962,5237438.95
6094,17,1398000,6529,6549,7214,20,170.53,1614143.0049603174,5237438.95
6095,17,900000,6532,6557,7305,25,170.53,1614143.0049603174,5237438.95
6096,22,700000,6532,6569,7225,37,170.53,2904103.2512077293,5237438.95
6097,16,1000000,6532,6773,8068,241,170.53,2465023.1840707962,5237438.95
6098,1,700000,6533,6557,7739,24,170.53,3325419.7044334975,5237438.95
6099,11,1000000,6535,6577,7296,42,170.53,1820371.57,5237438.95
6100,12,800000,6872,6911,7614,39,159.56,7658937.101338432,6271224.19
6101,17,600000,6538,6562,6926,24,170.53,1614143.0049603174,5237438.95
6102,11,999999,6540,6591,8165,51,170.53,1820371.57,5237438.95
6103,5,700000,6540,6596,7421,56,170.53,1400922.5020242915,5237438.95
6104,24,2000000,6540,6562,7970,22,170.53,23456062.532786883,5237438.95
6105,23,600000,6541,6568,7884,27,170.53,5772926.70157068,5237438.95
6106,11,1000000,6542,6576,8111,34,170.53,1820371.57,5237438.95
6107,21,1000000,6542,6801,7596,259,170.53,17091199.984,5237438.95
6108,18,900000,6543,6576,8858,33,170.53,8584355.493548388,5237438.95
6109,2,1100000,6543,6561,8683,18,170.53,2989003.2716499544,5237438.95
6110,2,1000000,6543,6576,7415,33,170.53,2989003.2716499544,5237438.95
6111,19,900000,6543,6577,7626,34,170.53,6721340.5708154505,5237438.95
6112,2,2700000,6547,6576,6919,29,170.53,2989003.2716499544,5237438.95
6113,21,43000000,6547,7094,8529,547,170.53,17091199.984,5237438.95
6114,11,800000,6547,6576,8313,29,170.53,1820371.57,5237438.95
6115,11,600000,6549,6577,8480,28,170.53,1820371.57,5237438.95
6116,10,10000000,6550,7002,8172,452,170.53,8282326.220930233,5237438.95
6117,10,2500000,6550,7002,7966,452,170.53,8282326.220930233,5237438.95
6118,5,800000,6554,6589,7824,35,170.53,1400922.5020242915,5237438.95
6119,1,1000000,6554,6576,6933,22,170.53,3325419.7044334975,5237438.95
6120,22,750000,6554,6576,7527,22,170.53,2904103.2512077293,5237438.95
6121,17,1200000,6555,6577,7954,22,170.53,1614143.0049603174,5237438.95
6122,1,800000,6556,6576,7798,20,170.53,3325419.7044334975,5237438.95
6123,2,800000,6556,6606,7183,50,170.53,2989003.2716499544,5237438.95
6124,17,700000,6557,6582,7430,25,170.53,1614143.0049603174,5237438.95
6125,23,600000,6557,6637,8370,80,170.53,5772926.70157068,5237438.95
6126,2,800000,6558,6582,8059,24,170.53,2989003.2716499544,5237438.95
6127,2,955190,6560,6583,7358,23,170.53,2989003.2716499544,5237438.95
6128,1,700000,6560,6680,7724,120,170.53,3325419.7044334975,5237438.95
6129,8,4800000,6560,6974,8061,414,170.53,1501617.2191780822,5237438.95
6130,18,1000000,6560,6576,7362,16,170.53,8584355.493548388,5237438.95
6131,11,600000,6561,6569,7346,8,170.53,1820371.57,5237438.95
6132,17,550000,6562,6592,6983,30,170.53,1614143.0049603174,5237438.95
6133,15,700000,6562,6605,7438,43,170.53,4522577.48037889,5237438.95
6134,17,838000,6563,6620,7043,57,170.53,1614143.0049603174,5237438.95
6135,21,999000,6564,6595,7208,31,170.53,17091199.984,5237438.95
6136,2,1118800,6564,6602,7179,38,170.53,2989003.2716499544,5237438.95
6137,2,1000000,6564,7124,7418,560,170.53,2989003.2716499544,5237438.95
6138,8,2880000,6567,6968,7997,401,170.53,1501617.2191780822,5237438.95
6139,8,2880000,6567,6968,7997,401,170.53,1501617.2191780822,5237438.95
6140,8,2880000,6567,6968,7997,401,170.53,1501617.2191780822,5237438.95
6141,8,2880000,6567,6968,7997,401,170.53,1501617.2191780822,5237438.95
6142,8,2880000,6567,6968,7997,401,170.53,1501617.2191780822,5237438.95
6143,8,2880000,6567,6968,7997,401,170.53,1501617.2191780822,5237438.95
6144,8,2880000,6567,6968,7998,401,170.53,1501617.2191780822,5237438.95
6145,8,2880000,6567,6968,7998,401,170.53,1501617.2191780822,5237438.95
6146,8,2880000,6567,6968,7998,401,170.53,1501617.2191780822,5237438.95
6147,8,2880000,6567,6968,7998,401,170.53,1501617.2191780822,5237438.95
6148,8,2880000,6567,6968,7998,401,170.53,1501617.2191780822,5237438.95
6149,8,2880000,6567,6968,7998,401,170.53,1501617.2191780822,5237438.95
6150,8,2880000,6567,6968,7998,401,170.53,1501617.2191780822,5237438.95
6151,8,2880000,6567,6968,7998,401,170.53,1501617.2191780822,5237438.95
6152,8,2880000,6567,6968,7998,401,170.53,1501617.2191780822,5237438.95
6153,8,2880000,6567,6968,7998,401,170.53,1501617.2191780822,5237438.95
6154,8,2880000,6567,6968,7998,401,170.53,1501617.2191780822,5237438.95
6155,8,2880000,6567,6968,7998,401,170.53,1501617.2191780822,5237438.95
6156,8,14400000,6567,6968,8186,401,170.53,1501617.2191780822,5237438.95
6157,11,700000,6567,6700,7041,133,170.53,1820371.57,5237438.95
6158,11,950000,6568,6704,7263,136,170.53,1820371.57,5237438.95
6159,11,950000,6568,6704,7263,136,170.53,1820371.57,5237438.95
6160,2,800000,6568,6584,7345,16,170.53,2989003.2716499544,5237438.95
6161,2,860490,6569,6602,7830,33,170.53,2989003.2716499544,5237438.95
6162,15,650000,6569,6647,8319,78,170.53,4522577.48037889,5237438.95
6163,2,900000,6570,6626,7127,56,170.53,2989003.2716499544,5237438.95
6164,2,900000,6571,6595,7185,24,170.53,2989003.2716499544,5237438.95
6165,2,800000,6571,6644,7366,73,170.53,2989003.2716499544,5237438.95
6166,2,900000,6571,6630,7313,59,170.53,2989003.2716499544,5237438.95
6167,17,650000,6574,6595,7184,21,170.53,1614143.0049603174,5237438.95
6168,2,789050,6574,6617,7697,43,170.53,2989003.2716499544,5237438.95
6169,13,2000000,6574,6584,6765,10,170.53,7795654.71978022,5237438.95
6170,2,740015,6575,6606,6926,31,170.53,2989003.2716499544,5237438.95
6171,3,1000000,6575,6597,7123,22,170.53,9246769.549865229,5237438.95
6172,17,3850000,6576,7621,7789,1045,170.53,1614143.0049603174,5237438.95
6173,18,800000,6577,6596,7529,19,170.53,8584355.493548388,5237438.95
6174,12,750000,6577,6606,7901,29,170.53,7658937.101338432,5237438.95
6175,3,999999,6577,6618,6889,41,170.53,9246769.549865229,5237438.95
6176,11,601590,6578,6626,7529,48,170.53,1820371.57,5237438.95
6177,7,5000000,6582,6962,7907,380,170.53,3738553.685483871,5237438.95
6178,7,5000000,6582,6962,7907,380,170.53,3738553.685483871,5237438.95
6179,7,5000000,6582,6962,7907,380,170.53,3738553.685483871,5237438.95
6180,7,5000000,6582,6962,7907,380,170.53,3738553.685483871,5237438.95
6181,7,5000000,6582,6962,7907,380,170.53,3738553.685483871,5237438.95
6182,7,5000000,6582,6962,7907,380,170.53,3738553.685483871,5237438.95
6183,7,5000000,6582,6962,7907,380,170.53,3738553.685483871,5237438.95
6184,7,5000000,6582,6962,7907,380,170.53,3738553.685483871,5237438.95
6185,7,5000000,6582,6962,7907,380,170.53,3738553.685483871,5237438.95
6186,7,5000000,6582,6962,7907,380,170.53,3738553.685483871,5237438.95
6187,7,5000000,6582,6962,7907,380,170.53,3738553.685483871,5237438.95
6188,7,5000000,6582,6962,7907,380,170.53,3738553.685483871,5237438.95
6189,7,5000000,6582,6962,7907,380,170.53,3738553.685483871,5237438.95
6190,7,5000000,6582,6962,7907,380,170.53,3738553.685483871,5237438.95
6191,7,5000000,6582,6962,7907,380,170.53,3738553.685483871,5237438.95
6192,7,5000000,6582,6962,7907,380,170.53,3738553.685483871,5237438.95
6193,7,5000000,6582,6962,7907,380,170.53,3738553.685483871,5237438.95
6194,7,5000000,6582,6962,7907,380,170.53,3738553.685483871,5237438.95
6195,7,5000000,6582,6962,7907,380,170.53,3738553.685483871,5237438.95
6196,7,5000000,6582,6962,7907,380,170.53,3738553.685483871,5237438.95
6197,7,5000000,6582,6962,7907,380,170.53,3738553.685483871,5237438.95
6198,7,5000000,6582,6962,7899,380,170.53,3738553.685483871,5237438.95
6199,7,5000000,6582,6962,7907,380,170.53,3738553.685483871,5237438.95
6200,7,5000000,6582,6962,7899,380,170.53,3738553.685483871,5237438.95
6201,7,5000000,6582,6962,7907,380,170.53,3738553.685483871,5237438.95
6202,7,5000000,6582,6962,7907,380,170.53,3738553.685483871,5237438.95
6203,7,5000000,6582,6962,7907,380,170.53,3738553.685483871,5237438.95
6204,7,5000000,6582,6962,7907,380,170.53,3738553.685483871,5237438.95
6205,17,1000000,6583,6609,7110,26,170.53,1614143.0049603174,5237438.95
6206,3,1000000,6583,6595,6883,12,170.53,9246769.549865229,5237438.95
6207,7,5000000,6585,6966,8368,381,170.53,3738553.685483871,5237438.95
6208,7,5000000,6585,6966,7886,381,170.53,3738553.685483871,5237438.95
6209,7,5000000,6585,6966,7886,381,170.53,3738553.685483871,5237438.95
6210,7,5000000,6585,6966,7894,381,170.53,3738553.685483871,5237438.95
6211,7,5000000,6585,6966,7894,381,170.53,3738553.685483871,5237438.95
6212,7,5000000,6585,6966,7894,381,170.53,3738553.685483871,5237438.95
6213,7,5000000,6585,6966,7894,381,170.53,3738553.685483871,5237438.95
6214,7,5000000,6585,6966,7894,381,170.53,3738553.685483871,5237438.95
6215,7,5000000,6585,6966,7907,381,170.53,3738553.685483871,5237438.95
6216,7,5000000,6585,6966,7907,381,170.53,3738553.685483871,5237438.95
6217,7,5000000,6585,6966,7907,381,170.53,3738553.685483871,5237438.95
6218,7,5000000,6585,6966,7907,381,170.53,3738553.685483871,5237438.95
6219,7,5000000,6585,6966,7907,381,170.53,3738553.685483871,5237438.95
6220,7,5000000,6585,6966,7907,381,170.53,3738553.685483871,5237438.95
6221,7,5000000,6585,6966,7907,381,170.53,3738553.685483871,5237438.95
6222,7,5000000,6585,6966,7907,381,170.53,3738553.685483871,5237438.95
6223,7,5000000,6585,6966,7907,381,170.53,3738553.685483871,5237438.95
6224,7,5000000,6585,6966,7907,381,170.53,3738553.685483871,5237438.95
6225,7,5000000,6585,6966,7907,381,170.53,3738553.685483871,5237438.95
6226,7,5000000,6585,6966,7907,381,170.53,3738553.685483871,5237438.95
6227,7,5000000,6585,6966,7907,381,170.53,3738553.685483871,5237438.95
6228,7,5000000,6585,6966,7907,381,170.53,3738553.685483871,5237438.95
6229,7,5000000,6585,6966,7907,381,170.53,3738553.685483871,5237438.95
6230,7,5000000,6585,6966,7907,381,170.53,3738553.685483871,5237438.95
6231,7,5000000,6585,6966,7907,381,170.53,3738553.685483871,5237438.95
6232,7,5000000,6585,6966,7907,381,170.53,3738553.685483871,5237438.95
6233,7,5000000,6585,6966,7907,381,170.53,3738553.685483871,5237438.95
6234,7,5000000,6585,6966,7907,381,170.53,3738553.685483871,5237438.95
6235,12,1400000,6588,6637,8276,49,170.53,7658937.101338432,5237438.95
6236,5,592500,6589,6855,7635,266,170.53,1400922.5020242915,5237438.95
6237,17,999999,6590,6619,7277,29,170.53,1614143.0049603174,5237438.95
6238,2,700000,6590,6786,7337,196,170.53,2989003.2716499544,5237438.95
6239,17,650000,6590,6702,7254,112,170.53,1614143.0049603174,5237438.95
6240,7,10000000,6590,6886,7936,296,170.53,3738553.685483871,5237438.95
6241,7,10000000,6590,6886,7936,296,170.53,3738553.685483871,5237438.95
6242,15,600000,6590,6647,8738,57,170.53,4522577.48037889,5237438.95
6243,15,600000,6591,6647,8656,56,170.53,4522577.48037889,5237438.95
6244,2,700000,6591,6616,7619,25,170.53,2989003.2716499544,5237438.95
6245,21,120000000,6592,8047,8717,1455,170.53,17091199.984,5237438.95
6246,1,600000,6592,6675,7522,83,170.53,3325419.7044334975,5237438.95
6247,15,800000,6596,6681,7766,85,170.53,4522577.48037889,5237438.95
6248,13,1200000,6597,6611,7617,14,170.53,7795654.71978022,5237438.95
6249,11,700000,6597,6612,7877,15,170.53,1820371.57,5237438.95
6250,2,900000,6598,6617,7282,19,170.53,2989003.2716499544,5237438.95
6251,17,600000,6599,6687,8163,88,170.53,1614143.0049603174,5237438.95
6252,3,750000,6602,6623,7291,21,170.53,9246769.549865229,5237438.95
6253,13,750000,6609,6700,7453,91,170.53,7795654.71978022,5237438.95
6254,16,1100000,6610,6626,6989,16,170.53,2465023.1840707962,5237438.95
6255,2,550000,6611,6630,7323,19,170.53,2989003.2716499544,5237438.95
6256,2,736030,6613,6639,6977,26,170.53,2989003.2716499544,5237438.95
6257,12,750000,6616,6637,7740,21,170.53,7658937.101338432,5237438.95
6258,17,600000,6616,6651,7310,35,170.53,1614143.0049603174,5237438.95
6259,17,560000,6616,6681,7347,65,170.53,1614143.0049603174,5237438.95
6260,24,3000000,6617,6843,7127,226,170.53,23456062.532786883,5237438.95
6261,11,1000000,6617,6652,7604,35,170.53,1820371.57,5237438.95
6262,2,800000,6617,6639,8270,22,170.53,2989003.2716499544,5237438.95
6263,2,826735,6618,6633,7305,15,170.53,2989003.2716499544,5237438.95
6264,3,3500000,6618,6764,7436,146,170.53,9246769.549865229,5237438.95
6265,16,1350000,6619,6644,8187,25,170.53,2465023.1840707962,5237438.95
6266,11,1000000,6620,6639,8361,19,170.53,1820371.57,5237438.95
6267,3,1000000,6620,6624,6743,4,170.53,9246769.549865229,5237438.95
6268,3,600000,6623,6651,7115,28,170.53,9246769.549865229,5237438.95
6269,11,750000,6624,6651,7158,27,170.53,1820371.57,5237438.95
6270,2,900000,6624,6654,8501,30,170.53,2989003.2716499544,5237438.95
6271,24,2500000,6625,6631,8053,6,170.53,23456062.532786883,5237438.95
6272,11,700000,6627,6641,7381,14,170.53,1820371.57,5237438.95
6273,21,70000000,6627,7771,8174,1144,170.53,17091199.984,5237438.95
6274,12,1000000,6630,6647,7640,17,170.53,7658937.101338432,5237438.95
6275,11,1000000,6631,6675,7541,44,170.53,1820371.57,5237438.95
6276,17,600000,6632,6723,7071,91,170.53,1614143.0049603174,5237438.95
6277,15,550000,6634,6717,7365,83,170.53,4522577.48037889,5237438.95
6278,24,1700000,6637,6716,7065,79,170.53,23456062.532786883,5237438.95
6279,22,800000,6638,6676,7656,38,170.53,2904103.2512077293,5237438.95
6280,3,1560000,6639,6674,6820,35,170.53,9246769.549865229,5237438.95
6281,21,8000000,6639,6673,7402,34,170.53,17091199.984,5237438.95
6282,5,600000,6640,6707,7262,67,170.53,1400922.5020242915,5237438.95
6283,11,550000,6644,6763,7743,119,170.53,1820371.57,5237438.95
6284,24,900000,6644,6739,6976,95,170.53,23456062.532786883,5237438.95
6285,16,700000,6644,6655,7590,11,170.53,2465023.1840707962,5237438.95
6286,18,800000,6647,6760,8748,113,170.53,8584355.493548388,5237438.95
6287,8,900000,6648,6676,7366,28,170.53,1501617.2191780822,5237438.95
6288,16,660000,6648,6676,7221,28,170.53,2465023.1840707962,5237438.95
6289,12,3000000,6648,6676,7299,28,170.53,7658937.101338432,5237438.95
6290,11,810000,6651,6799,7782,148,170.53,1820371.57,5237438.95
6291,24,60000000,6653,7597,8583,944,170.53,23456062.532786883,5237438.95
6292,12,3000000,6653,6708,7746,55,170.53,7658937.101338432,5237438.95
6293,17,576800,6653,6676,8564,23,170.53,1614143.0049603174,5237438.95
6294,3,2400000,6654,7660,8292,1006,170.53,9246769.549865229,5237438.95
6295,3,2400000,6654,7661,8292,1007,170.53,9246769.549865229,5237438.95
6296,3,2100000,6654,7464,8292,810,170.53,9246769.549865229,5237438.95
6297,11,1000000,6654,6681,7338,27,170.53,1820371.57,5237438.95
6298,3,1200000,6654,7460,8292,806,170.53,9246769.549865229,5237438.95
6299,3,1200000,6654,7460,8292,806,170.53,9246769.549865229,5237438.95
6300,3,2400000,6654,7460,8292,806,170.53,9246769.549865229,5237438.95
6301,9,550000,6654,6688,7571,34,170.53,3707403.8834951455,5237438.95
6302,24,30000000,6654,7625,8703,971,170.53,23456062.532786883,5237438.95
6303,15,121000000,6655,7572,8762,917,170.53,4522577.48037889,5237438.95
6304,21,4500000,6655,7564,8481,909,170.53,17091199.984,5237438.95
6305,13,560000,6660,6700,8228,40,170.53,7795654.71978022,5237438.95
6306,9,600000,6661,6688,8033,27,170.53,3707403.8834951455,5237438.95
6307,17,700000,6661,6674,7359,13,170.53,1614143.0049603174,5237438.95
6308,8,1190000,6662,7081,7829,419,170.53,1501617.2191780822,5237438.95
6309,12,1000000,6669,6820,7949,151,159.56,7658937.101338432,6271224.19
6310,20,1000000,6669,6697,6896,28,159.56,7597088.421768707,6271224.19
6311,18,750000,6669,6730,7256,61,159.56,8584355.493548388,6271224.19
6312,1,750280,6669,6758,7268,89,159.56,3325419.7044334975,6271224.19
6313,10,2000000,6672,6807,7351,135,159.56,8282326.220930233,6271224.19
6314,10,2000000,6672,6807,7351,135,159.56,8282326.220930233,6271224.19
6315,10,2000000,6672,6795,7351,123,159.56,8282326.220930233,6271224.19
6316,10,2000000,6672,6795,7351,123,159.56,8282326.220930233,6271224.19
6317,2,1000000,6673,6694,7193,21,159.56,2989003.2716499544,6271224.19
6318,0,550000,6675,6781,7829,106,159.56,8418173.322222222,6271224.19
6319,2,800000,6675,6750,7285,75,159.56,2989003.2716499544,6271224.19
6320,19,612000,6679,6724,8724,45,159.56,6721340.5708154505,6271224.19
6321,17,900000,6679,6721,7379,42,159.56,1614143.0049603174,6271224.19
6322,19,575000,6680,6784,8250,104,159.56,6721340.5708154505,6271224.19
6323,2,800000,6680,6752,7347,72,159.56,2989003.2716499544,6271224.19
6324,2,700000,6686,6729,7857,43,159.56,2989003.2716499544,6271224.19
6325,2,800000,6687,6701,7698,14,159.56,2989003.2716499544,6271224.19
6326,12,530000,6693,6798,7200,105,159.56,7658937.101338432,6271224.19
6327,24,3400000,6693,6745,8500,52,159.56,23456062.532786883,6271224.19
6328,24,1200000,6694,6743,7179,49,159.56,23456062.532786883,6271224.19
6329,17,950000,6694,6785,7459,91,159.56,1614143.0049603174,6271224.19
6330,15,1000000,6696,6718,8899,22,159.56,4522577.48037889,6271224.19
6331,2,750000,6697,6711,7008,14,159.56,2989003.2716499544,6271224.19
6332,22,600000,6700,6743,7571,43,159.56,2904103.2512077293,6271224.19
6333,4,1200000,6701,6718,7681,17,159.56,4297914.794871795,6271224.19
6334,2,987000,6701,6723,7849,22,159.56,2989003.2716499544,6271224.19
6335,5,750000,6702,6763,7151,61,159.56,1400922.5020242915,6271224.19
6336,10,700000,6702,6722,7631,20,159.56,8282326.220930233,6271224.19
6337,22,800000,6703,6841,8010,138,159.56,2904103.2512077293,6271224.19
6338,11,650000,6704,6765,7690,61,159.56,1820371.57,6271224.19
6339,1,700000,6704,6721,7255,17,159.56,3325419.7044334975,6271224.19
6340,7,800000,6707,6927,7919,220,159.56,3738553.685483871,6271224.19
6341,17,662500,6709,6725,7375,16,159.56,1614143.0049603174,6271224.19
6342,20,800000,6709,6736,7598,27,159.56,7597088.421768707,6271224.19
6343,15,575000,6709,6737,7625,28,159.56,4522577.48037889,6271224.19
6344,2,600000,6710,6729,7176,19,159.56,2989003.2716499544,6271224.19
6345,17,800000,6710,6729,8249,19,159.56,1614143.0049603174,6271224.19
6346,11,900000,6711,6780,7981,69,159.56,1820371.57,6271224.19
6347,13,800000,6711,6808,7782,97,159.56,7795654.71978022,6271224.19
6348,2,950000,6711,6766,7799,55,159.56,2989003.2716499544,6271224.19
6349,19,1354800,6715,6795,7682,80,159.56,6721340.5708154505,6271224.19
6350,23,700000,6715,6840,7312,125,159.56,5772926.70157068,6271224.19
6351,18,700000,6715,6746,7291,31,159.56,8584355.493548388,6271224.19
6352,17,800000,6716,6744,7068,28,159.56,1614143.0049603174,6271224.19
6353,11,675000,6716,6723,7131,7,159.56,1820371.57,6271224.19
6354,24,1000000,6717,6785,7880,68,159.56,23456062.532786883,6271224.19
6355,18,700000,6717,6735,7372,18,159.56,8584355.493548388,6271224.19
6356,17,550000,6717,6743,8215,26,159.56,1614143.0049603174,6271224.19
6357,17,1100000,6721,6736,7313,15,159.56,1614143.0049603174,6271224.19
6358,2,950000,6721,6836,8352,115,159.56,2989003.2716499544,6271224.19
6359,15,650000,6721,6757,7045,36,159.56,4522577.48037889,6271224.19
6360,3,750000,6722,6763,7379,41,159.56,9246769.549865229,6271224.19
6361,8,850000,6722,6744,7541,22,159.56,1501617.2191780822,6271224.19
6362,11,800000,6722,6766,7465,44,159.56,1820371.57,6271224.19
6363,2,800000,6722,6774,7248,52,159.56,2989003.2716499544,6271224.19
6364,24,1700000,6722,6750,7010,28,159.56,23456062.532786883,6271224.19
6365,11,800000,6723,6793,7465,70,159.56,1820371.57,6271224.19
6366,3,2000000,6723,6766,7031,43,159.56,9246769.549865229,6271224.19
6367,10,50000000,6724,7298,8473,574,159.56,8282326.220930233,6271224.19
6368,21,15000000,6724,6820,8523,96,159.56,17091199.984,6271224.19
6369,21,15000000,6724,6820,8520,96,159.56,17091199.984,6271224.19
6370,21,1100000,6724,6829,6954,105,159.56,17091199.984,6271224.19
6371,15,564000,6728,6773,8275,45,159.56,4522577.48037889,6271224.19
6372,24,1200000,6729,6785,7086,56,159.56,23456062.532786883,6271224.19
6373,11,1000000,6729,6784,7838,55,159.56,1820371.57,6271224.19
6374,17,800000,6730,6766,7537,36,159.56,1614143.0049603174,6271224.19
6375,17,700000,6730,6777,7453,47,159.56,1614143.0049603174,6271224.19
6376,16,800000,6731,6750,7716,19,159.56,2465023.1840707962,6271224.19
6377,15,600000,6732,6750,8576,18,159.56,4522577.48037889,6271224.19
6378,17,550000,6732,6737,6875,5,159.56,1614143.0049603174,6271224.19
6379,13,50000000,6732,7775,8745,1043,159.56,7795654.71978022,6271224.19
6380,22,800000,6732,6927,7428,195,159.56,2904103.2512077293,6271224.19
6381,5,1000000,6735,6770,7614,35,159.56,1400922.5020242915,6271224.19
6382,15,800190,6736,6759,7665,23,159.56,4522577.48037889,6271224.19
6383,17,700000,6736,6749,6871,13,159.56,1614143.0049603174,6271224.19
6384,18,800000,6736,6807,7677,71,159.56,8584355.493548388,6271224.19
6385,24,800000,6737,6767,7043,30,159.56,23456062.532786883,6271224.19
6386,16,800000,6737,6780,8031,43,159.56,2465023.1840707962,6271224.19
6387,2,896205,6737,6758,7732,21,159.56,2989003.2716499544,6271224.19
6388,2,1065255,6738,6802,8892,64,159.56,2989003.2716499544,6271224.19
6389,15,895000,6739,6767,7675,28,159.56,4522577.48037889,6271224.19
6390,3,44000000,6742,7136,8207,394,159.56,9246769.549865229,6271224.19
6391,17,750000,6742,6759,7099,17,159.56,1614143.0049603174,6271224.19
6392,16,850000,6742,6766,7800,24,159.56,2465023.1840707962,6271224.19
6393,4,650000,6743,6778,7512,35,159.56,4297914.794871795,6271224.19
6394,18,730000,6743,6785,8046,42,159.56,8584355.493548388,6271224.19
6395,16,1500000,6744,6820,7605,76,159.56,2465023.1840707962,6271224.19
6396,13,580000,6745,7039,7260,294,159.56,7795654.71978022,6271224.19
6397,1,800000,6749,6766,7262,17,159.56,3325419.7044334975,6271224.19
6398,11,900000,6749,6813,7299,64,159.56,1820371.57,6271224.19
6399,4,700000,6749,6772,7208,23,159.56,4297914.794871795,6271224.19
6400,16,550000,6750,6766,7268,16,159.56,2465023.1840707962,6271224.19
6401,19,800000,6751,6786,7558,35,159.56,6721340.5708154505,6271224.19
6402,22,550000,6752,6773,7858,21,159.56,2904103.2512077293,6271224.19
6403,16,750000,6757,6774,7603,17,159.56,2465023.1840707962,6271224.19
6404,16,600000,6757,6816,7225,59,159.56,2465023.1840707962,6271224.19
6405,2,700000,6757,6799,7403,42,159.56,2989003.2716499544,6271224.19
6406,23,600000,6758,6780,7052,22,159.56,5772926.70157068,6271224.19
6407,3,1000000,6758,6786,8433,28,159.56,9246769.549865229,6271224.19
6408,0,750000,6758,6787,7513,29,159.56,8418173.322222222,6271224.19
6409,22,3250000,6759,6837,7638,78,159.56,2904103.2512077293,6271224.19
6410,22,3250000,6759,6837,7638,78,159.56,2904103.2512077293,6271224.19
6411,22,3250000,6760,6837,7638,77,159.56,2904103.2512077293,6271224.19
6412,17,1200000,6760,6793,6891,33,159.56,1614143.0049603174,6271224.19
6413,22,3250000,6760,6837,7638,77,159.56,2904103.2512077293,6271224.19
6414,12,1200000,6760,6927,7792,167,159.56,7658937.101338432,6271224.19
6415,4,700000,6763,6827,7619,64,159.56,4297914.794871795,6271224.19
6416,1,1000000,6763,6820,7703,57,159.56,3325419.7044334975,6271224.19
6417,1,1000000,6763,6820,7703,57,159.56,3325419.7044334975,6271224.19
6418,17,875000,6764,6799,7725,35,159.56,1614143.0049603174,6271224.19
6419,20,620000,6764,6788,7331,24,159.56,7597088.421768707,6271224.19
6420,11,520000,6765,6806,7290,41,159.56,1820371.57,6271224.19
6421,8,1150000,6765,6809,7080,44,159.56,1501617.2191780822,6271224.19
6422,17,700000,6765,6792,7975,27,159.56,1614143.0049603174,6271224.19
6423,17,1250000,6765,6813,7810,48,159.56,1614143.0049603174,6271224.19
6424,24,720500,6766,6800,7124,34,159.56,23456062.532786883,6271224.19
6425,15,1000000,6767,6815,7679,48,159.56,4522577.48037889,6271224.19
6426,15,600000,6767,6822,8094,55,159.56,4522577.48037889,6271224.19
6427,17,1000000,6770,6806,7625,36,159.56,1614143.0049603174,6271224.19
6428,18,680000,6770,6822,7841,52,159.56,8584355.493548388,6271224.19
6429,17,717560,6771,6821,7323,50,159.56,1614143.0049603174,6271224.19
6430,1,800000,6771,6802,7443,31,159.56,3325419.7044334975,6271224.19
6431,15,600000,6772,6935,7499,163,159.56,4522577.48037889,6271224.19
6432,15,600000,6772,6935,7478,163,159.56,4522577.48037889,6271224.19
6433,12,1500000,6772,6784,7692,12,159.56,7658937.101338432,6271224.19
6434,17,600000,6772,6828,8010,56,159.56,1614143.0049603174,6271224.19
6435,17,3000000,6773,7439,7887,666,159.56,1614143.0049603174,6271224.19
6436,1,700000,6773,6792,7403,19,159.56,3325419.7044334975,6271224.19
6437,2,1076680,6773,6826,7660,53,159.56,2989003.2716499544,6271224.19
6438,17,600000,6774,6812,7666,38,159.56,1614143.0049603174,6271224.19
6439,4,750000,6777,6826,7386,49,159.56,4297914.794871795,6271224.19
6440,17,750000,6777,6809,8503,32,159.56,1614143.0049603174,6271224.19
6441,2,800000,6779,6827,7242,48,159.56,2989003.2716499544,6271224.19
6442,17,1500000,6780,6816,7885,36,159.56,1614143.0049603174,6271224.19
6443,11,657400,6781,6798,7428,17,159.56,1820371.57,6271224.19
6444,1,857000,6781,6819,7208,38,159.56,3325419.7044334975,6271224.19
6445,21,2800000,6781,6827,7275,46,159.56,17091199.984,6271224.19
6446,15,900000,6784,6801,8051,17,159.56,4522577.48037889,6271224.19
6447,9,600000,6784,6903,7794,119,159.56,3707403.8834951455,6271224.19
6448,17,1200000,6785,6806,8234,21,159.56,1614143.0049603174,6271224.19
6449,17,1600000,6785,6813,7932,28,159.56,1614143.0049603174,6271224.19
6450,2,700000,6786,6830,7507,44,159.56,2989003.2716499544,6271224.19
6451,19,875340,6787,6802,7528,15,159.56,6721340.5708154505,6271224.19
6452,16,650000,6787,6794,7276,7,159.56,2465023.1840707962,6271224.19
6453,5,600000,6788,6807,7666,19,159.56,1400922.5020242915,6271224.19
6454,15,800000,6788,6855,7304,67,159.56,4522577.48037889,6271224.19
6455,15,1200000,6788,6809,7437,21,159.56,4522577.48037889,6271224.19
6456,2,800000,6792,6821,7459,29,159.56,2989003.2716499544,6271224.19
6457,0,650000,6793,6889,8716,96,159.56,8418173.322222222,6271224.19
6458,2,1000000,6793,6833,7262,40,159.56,2989003.2716499544,6271224.19
6459,17,750000,6794,6822,7429,28,159.56,1614143.0049603174,6271224.19
6460,16,900000,6795,6843,8143,48,159.56,2465023.1840707962,6271224.19
6461,24,15000000,6795,6829,7663,34,159.56,23456062.532786883,6271224.19
6462,15,700000,6798,6813,7695,15,159.56,4522577.48037889,6271224.19
6463,2,600000,6798,6827,8713,29,159.56,2989003.2716499544,6271224.19
6464,1,700000,6798,6844,8088,46,159.56,3325419.7044334975,6271224.19
6465,11,1000000,6799,6815,7719,16,159.56,1820371.57,6271224.19
6466,1,36000000,6799,7526,8088,727,159.56,3325419.7044334975,6271224.19
6467,16,700000,6799,6884,7803,85,159.56,2465023.1840707962,6271224.19
6468,11,1000000,6800,6856,7429,56,159.56,1820371.57,6271224.19
6469,12,1150000,6801,6822,7570,21,159.56,7658937.101338432,6271224.19
6470,10,600000,6802,6857,7411,55,159.56,8282326.220930233,6271224.19
6471,10,600000,6802,6857,7381,55,159.56,8282326.220930233,6271224.19
6472,21,800000,6806,6822,7612,16,159.56,17091199.984,6271224.19
6473,15,800000,6806,6875,7255,69,159.56,4522577.48037889,6271224.19
6474,15,800000,6806,6875,7255,69,159.56,4522577.48037889,6271224.19
6475,10,800000,6807,6994,7780,187,159.56,8282326.220930233,6271224.19
6476,18,900000,6807,6897,8103,90,159.56,8584355.493548388,6271224.19
6477,18,900000,6809,6857,8608,48,159.56,8584355.493548388,6271224.19
6478,21,3000000,6809,6836,7150,27,159.56,17091199.984,6271224.19
6479,15,690000,6812,6833,7540,21,159.56,4522577.48037889,6271224.19
6480,12,1000000,6813,6827,7751,14,159.56,7658937.101338432,6271224.19
6481,17,750000,6813,6854,6892,41,159.56,1614143.0049603174,6271224.19
6482,12,1500000,6814,6896,7863,82,159.56,7658937.101338432,6271224.19
6483,15,525000,6814,6828,7669,14,159.56,4522577.48037889,6271224.19
6484,1,835000,6814,6835,7095,21,159.56,3325419.7044334975,6271224.19
6485,7,1500000,6815,6907,7774,92,159.56,3738553.685483871,6271224.19
6486,2,600000,6816,6836,7675,20,159.56,2989003.2716499544,6271224.19
6487,2,850000,6819,6855,7673,36,159.56,2989003.2716499544,6271224.19
6488,3,650000,6820,6848,7325,28,159.56,9246769.549865229,6271224.19
6489,17,900000,6820,6843,8681,23,159.56,1614143.0049603174,6271224.19
6490,2,900000,6820,6835,7662,15,159.56,2989003.2716499544,6271224.19
6491,6,700000,6821,6841,7362,20,159.56,1124713.2781954887,6271224.19
6492,6,700000,6821,6871,7331,50,159.56,1124713.2781954887,6271224.19
6493,22,790000,6821,6851,7262,30,159.56,2904103.2512077293,6271224.19
6494,15,700000,6822,6854,8417,32,159.56,4522577.48037889,6271224.19
6495,22,800000,6823,6865,8794,42,159.56,2904103.2512077293,6271224.19
6496,12,700000,6826,6863,7302,37,159.56,7658937.101338432,6271224.19
6497,2,800000,6826,6871,7792,45,159.56,2989003.2716499544,6271224.19
6498,6,750000,6826,6870,7600,44,159.56,1124713.2781954887,6271224.19
6499,1,2000000,6827,6841,7527,14,159.56,3325419.7044334975,6271224.19
6500,17,650000,6827,6875,8452,48,159.56,1614143.0049603174,6271224.19
6501,6,729640,6827,6856,7731,29,159.56,1124713.2781954887,6271224.19
6502,2,800000,6828,6885,7422,57,159.56,2989003.2716499544,6271224.19
6503,15,600000,6829,6836,7907,7,159.56,4522577.48037889,6271224.19
6504,17,1100000,6829,6844,8361,15,159.56,1614143.0049603174,6271224.19
6505,2,650000,6830,6919,8579,89,159.56,2989003.2716499544,6271224.19
6506,12,3000000,6830,6917,7878,87,159.56,7658937.101338432,6271224.19
6507,17,1000000,6830,6857,7059,27,159.56,1614143.0049603174,6271224.19
6508,16,780000,6830,6851,8013,21,159.56,2465023.1840707962,6271224.19
6509,19,600000,6830,6849,7718,19,159.56,6721340.5708154505,6271224.19
6510,5,950000,6833,7003,7535,170,159.56,1400922.5020242915,6271224.19
6511,17,800000,6833,6905,8150,72,159.56,1614143.0049603174,6271224.19
6512,3,650000,6833,6862,7102,29,159.56,9246769.549865229,6271224.19
6513,17,750000,6834,6851,7985,17,159.56,1614143.0049603174,6271224.19
6514,2,800000,6834,6864,8108,30,159.56,2989003.2716499544,6271224.19
6515,11,800000,6834,6885,7347,51,159.56,1820371.57,6271224.19
6516,12,2200000,6834,6892,8559,58,159.56,7658937.101338432,6271224.19
6517,2,1000000,6835,6854,7333,19,159.56,2989003.2716499544,6271224.19
6518,21,48000000,6836,7347,8192,511,159.56,17091199.984,6271224.19
6519,15,1000000,6836,6872,7290,36,159.56,4522577.48037889,6271224.19
6520,15,600000,6837,6871,7449,34,159.56,4522577.48037889,6271224.19
6521,11,1000000,6837,6872,8557,35,159.56,1820371.57,6271224.19
6522,24,1200000,6837,6868,7383,31,159.56,23456062.532786883,6271224.19
6523,17,1200000,6840,6858,7526,18,159.56,1614143.0049603174,6271224.19
6524,16,565000,6840,6869,7207,29,159.56,2465023.1840707962,6271224.19
6525,3,20000000,6841,6871,7430,30,159.56,9246769.549865229,6271224.19
6526,11,900000,6841,6875,7302,34,159.56,1820371.57,6271224.19
6527,17,800000,6842,6898,8802,56,159.56,1614143.0049603174,6271224.19
6528,11,650000,6842,6883,7281,41,159.56,1820371.57,6271224.19
6529,4,700000,6842,6878,7446,36,159.56,4297914.794871795,6271224.19
6530,19,700000,6843,6868,7995,25,159.56,6721340.5708154505,6271224.19
6531,2,800000,6843,6868,7262,25,159.56,2989003.2716499544,6271224.19
6532,3,900000,6844,6904,7117,60,159.56,9246769.549865229,6271224.19
6533,17,630000,6848,6883,7586,35,159.56,1614143.0049603174,6271224.19
6534,1,1000000,6848,6891,7745,43,159.56,3325419.7044334975,6271224.19
6535,18,1000000,6848,6865,8242,17,159.56,8584355.493548388,6271224.19
6536,2,750000,6849,6890,8138,41,159.56,2989003.2716499544,6271224.19
6537,22,1000000,6849,6914,7198,65,159.56,2904103.2512077293,6271224.19
6538,22,1000000,6849,6914,7198,65,159.56,2904103.2512077293,6271224.19
6539,11,1500000,6849,7008,7268,159,159.56,1820371.57,6271224.19
6540,11,900000,6849,6926,7962,77,159.56,1820371.57,6271224.19
6541,18,25664000,6850,7327,7894,477,159.56,8584355.493548388,6271224.19
6542,13,700000,6850,6864,7646,14,159.56,7795654.71978022,6271224.19
6543,2,550000,6850,6948,7527,98,159.56,2989003.2716499544,6271224.19
6544,15,530000,6850,6884,7320,34,159.56,4522577.48037889,6271224.19
6545,15,530000,6850,6884,7320,34,159.56,4522577.48037889,6271224.19
6546,21,800000,6851,6884,7144,33,159.56,17091199.984,6271224.19
6547,11,1500000,6851,6926,7733,75,159.56,1820371.57,6271224.19
6548,15,750000,6854,7052,7695,198,159.56,4522577.48037889,6271224.19
6549,5,800000,6855,6872,7919,17,159.56,1400922.5020242915,6271224.19
6550,5,800000,6855,6914,7919,59,159.56,1400922.5020242915,6271224.19
6551,15,900000,6855,6870,7345,15,159.56,4522577.48037889,6271224.19
6552,2,900000,6855,6897,7318,42,159.56,2989003.2716499544,6271224.19
6553,11,1000000,6856,6924,7718,68,159.56,1820371.57,6271224.19
6554,12,700000,6856,6883,7282,27,159.56,7658937.101338432,6271224.19
6555,2,800000,6856,6870,7250,14,159.56,2989003.2716499544,6271224.19
6556,17,600000,6857,6896,8430,39,159.56,1614143.0049603174,6271224.19
6557,16,750000,6857,6872,7638,15,159.56,2465023.1840707962,6271224.19
6558,11,33500000,6857,7548,8458,691,159.56,1820371.57,6271224.19
6559,17,577300,6861,7003,7915,142,159.56,1614143.0049603174,6271224.19
6560,15,1100000,6861,6886,8100,25,159.56,4522577.48037889,6271224.19
6561,23,1000000,6861,6960,7369,99,159.56,5772926.70157068,6271224.19
6562,11,2000000,6861,6890,7690,29,159.56,1820371.57,6271224.19
6563,24,742000,6862,6918,7276,56,159.56,23456062.532786883,6271224.19
6564,23,3900000,6862,7570,8027,708,159.56,5772926.70157068,6271224.19
6565,23,3900000,6862,7569,8027,707,159.56,5772926.70157068,6271224.19
6566,2,700000,6862,6889,7425,27,159.56,2989003.2716499544,6271224.19
6567,18,700000,6863,6928,8010,65,159.56,8584355.493548388,6271224.19
6568,15,4270000,6864,7145,8094,281,159.56,4522577.48037889,6271224.19
6569,23,800000,6864,6924,7822,60,159.56,5772926.70157068,6271224.19
6570,2,900000,6868,6905,7372,37,159.56,2989003.2716499544,6271224.19
6571,12,2000000,6868,6907,8584,39,159.56,7658937.101338432,6271224.19
6572,19,1000000,6869,6920,7737,51,159.56,6721340.5708154505,6271224.19
6573,17,3000000,6870,7045,7908,175,159.56,1614143.0049603174,6271224.19
6574,12,1100000,6871,6893,7484,22,159.56,7658937.101338432,6271224.19
6575,3,1000000,6872,6924,7299,52,159.56,9246769.549865229,6271224.19
6576,18,1000000,6872,6904,7599,32,159.56,8584355.493548388,6271224.19
6577,17,2000000,6872,6907,7844,35,159.56,1614143.0049603174,6271224.19
6578,11,1415850,6876,6913,8310,37,159.56,1820371.57,6271224.19
6579,12,1000000,6876,7012,8578,136,159.56,7658937.101338432,6271224.19
6580,2,600000,6877,6947,7340,70,159.56,2989003.2716499544,6271224.19
6581,4,675000,6877,6977,8388,100,159.56,4297914.794871795,6271224.19
6582,22,650000,6877,6925,7534,48,159.56,2904103.2512077293,6271224.19
6583,2,1000000,6878,6893,7282,15,159.56,2989003.2716499544,6271224.19
6584,2,800000,6878,7262,8369,384,159.56,2989003.2716499544,6271224.19
6585,11,1000000,6878,6898,7604,20,159.56,1820371.57,6271224.19
6586,2,835000,6879,6900,7297,21,159.56,2989003.2716499544,6271224.19
6587,11,600000,6884,6903,7521,19,159.56,1820371.57,6271224.19
6588,16,880000,6884,6925,7975,41,159.56,2465023.1840707962,6271224.19
6589,16,750000,6884,6912,7563,28,159.56,2465023.1840707962,6271224.19
6590,11,750000,6884,6918,7515,34,159.56,1820371.57,6271224.19
6591,2,1000000,6884,6904,7373,20,159.56,2989003.2716499544,6271224.19
6592,18,750000,6884,6921,7549,37,159.56,8584355.493548388,6271224.19
6593,1,800000,6885,6907,7660,22,159.56,3325419.7044334975,6271224.19
6594,12,1200000,6885,6898,7789,13,159.56,7658937.101338432,6271224.19
6595,16,600000,6885,7172,8380,287,159.56,2465023.1840707962,6271224.19
6596,16,650000,6885,7172,8380,287,159.56,2465023.1840707962,6271224.19
6597,16,675000,6885,6959,8380,74,159.56,2465023.1840707962,6271224.19
6598,16,675000,6886,6976,8380,90,159.56,2465023.1840707962,6271224.19
6599,16,680000,6886,6959,8380,73,159.56,2465023.1840707962,6271224.19
6600,16,680000,6886,6959,8380,73,159.56,2465023.1840707962,6271224.19
6601,16,675000,6886,6959,8380,73,159.56,2465023.1840707962,6271224.19
6602,16,680000,6886,6960,8380,74,159.56,2465023.1840707962,6271224.19
6603,16,660000,6886,6959,8380,73,159.56,2465023.1840707962,6271224.19
6604,16,750000,6886,6976,8380,90,159.56,2465023.1840707962,6271224.19
6605,16,680000,6886,6959,8380,73,159.56,2465023.1840707962,6271224.19
6606,16,600000,6886,7172,8380,286,159.56,2465023.1840707962,6271224.19
6607,16,600000,6886,6959,8380,73,159.56,2465023.1840707962,6271224.19
6608,16,600000,6886,6959,8380,73,159.56,2465023.1840707962,6271224.19
6609,16,600000,6886,6959,8380,73,159.56,2465023.1840707962,6271224.19
6610,16,600000,6886,7178,8380,292,159.56,2465023.1840707962,6271224.19
6611,16,600000,6886,6959,8380,73,159.56,2465023.1840707962,6271224.19
6612,16,600000,6886,6959,8380,73,159.56,2465023.1840707962,6271224.19
6613,16,600000,6886,6959,8380,73,159.56,2465023.1840707962,6271224.19
6614,2,900000,6886,6912,7689,26,159.56,2989003.2716499544,6271224.19
6615,1,569500,6886,6954,7842,68,159.56,3325419.7044334975,6271224.19
6616,16,650000,6886,6960,8384,74,159.56,2465023.1840707962,6271224.19
6617,16,650000,6886,6959,8380,73,159.56,2465023.1840707962,6271224.19
6618,16,650000,6886,6959,8380,73,159.56,2465023.1840707962,6271224.19
6619,16,650000,6886,7172,8384,286,159.56,2465023.1840707962,6271224.19
6620,16,650000,6886,7172,8380,286,159.56,2465023.1840707962,6271224.19
6621,16,600000,6891,6959,8380,68,159.56,2465023.1840707962,6271224.19
6622,16,600000,6891,6959,8380,68,159.56,2465023.1840707962,6271224.19
6623,19,800000,6891,6934,7576,43,159.56,6721340.5708154505,6271224.19
6624,17,700000,6891,6926,7984,35,159.56,1614143.0049603174,6271224.19
6625,17,750000,6893,6926,7338,33,159.56,1614143.0049603174,6271224.19
6626,1,735000,6893,6906,7618,13,159.56,3325419.7044334975,6271224.19
6627,2,955000,6897,6906,7701,9,159.56,2989003.2716499544,6271224.19
6628,11,675000,6897,7207,8002,310,159.56,1820371.57,6271224.19
6629,1,550000,6897,6940,7687,43,159.56,3325419.7044334975,6271224.19
6630,2,525000,6897,6933,7603,36,159.56,2989003.2716499544,6271224.19
6631,1,550000,6898,6940,7687,42,159.56,3325419.7044334975,6271224.19
6632,17,650000,6898,6913,7586,15,159.56,1614143.0049603174,6271224.19
6633,17,800000,6898,6917,7017,19,159.56,1614143.0049603174,6271224.19
6634,15,600000,6898,6939,7642,41,159.56,4522577.48037889,6271224.19
6635,15,800000,6899,6912,7834,13,159.56,4522577.48037889,6271224.19
6636,16,800000,6899,6954,7850,55,159.56,2465023.1840707962,6271224.19
6637,11,800000,6900,6920,7873,20,159.56,1820371.57,6271224.19
6638,17,1000000,6903,6991,7999,88,159.56,1614143.0049603174,6271224.19
6639,11,1236320,6903,6939,7865,36,159.56,1820371.57,6271224.19
6640,11,650000,6904,6921,8018,17,159.56,1820371.57,6271224.19
6641,11,650000,6904,6928,8018,24,159.56,1820371.57,6271224.19
6642,24,562000,6905,6911,7990,6,159.56,23456062.532786883,6271224.19
6643,15,800000,6905,6953,7890,48,159.56,4522577.48037889,6271224.19
6644,15,800000,6905,6953,7890,48,159.56,4522577.48037889,6271224.19
6645,22,750000,6905,7067,7743,162,159.56,2904103.2512077293,6271224.19
6646,17,900000,6905,6932,7638,27,159.56,1614143.0049603174,6271224.19
6647,15,1010000,6906,6921,8326,15,159.56,4522577.48037889,6271224.19
6648,2,900000,6907,6935,7569,28,159.56,2989003.2716499544,6271224.19
6649,2,940000,6911,6926,7368,15,159.56,2989003.2716499544,6271224.19
6650,2,850000,6911,6952,7774,41,159.56,2989003.2716499544,6271224.19
6651,2,700000,6911,6925,7222,14,159.56,2989003.2716499544,6271224.19
6652,15,620000,6913,6931,7676,18,159.56,4522577.48037889,6271224.19
6653,17,1000000,6914,6939,7778,25,159.56,1614143.0049603174,6271224.19
6654,16,832000,6917,6938,7674,21,159.56,2465023.1840707962,6271224.19
6655,19,600000,6917,7142,7767,225,159.56,6721340.5708154505,6271224.19
6656,24,1500000,6917,6935,7565,18,159.56,23456062.532786883,6271224.19
6657,2,900000,6918,6988,7698,70,159.56,2989003.2716499544,6271224.19
6658,11,700000,6918,6974,7745,56,159.56,1820371.57,6271224.19
6659,15,550000,6918,6933,7620,15,159.56,4522577.48037889,6271224.19
6660,15,625000,6920,6939,7801,19,159.56,4522577.48037889,6271224.19
6661,11,700000,6920,6953,7537,33,159.56,1820371.57,6271224.19
6662,17,2000000,6925,6974,7648,49,159.56,1614143.0049603174,6271224.19
6663,16,850000,6925,6949,7600,24,159.56,2465023.1840707962,6271224.19
6664,2,1150000,6925,7051,7655,126,159.56,2989003.2716499544,6271224.19
6665,2,800000,6926,6941,7571,15,159.56,2989003.2716499544,6271224.19
6666,12,4000000,6927,6956,8277,29,159.56,7658937.101338432,6271224.19
6667,2,650000,6928,6967,7764,39,159.56,2989003.2716499544,6271224.19
6668,2,650000,6928,6967,7764,39,159.56,2989003.2716499544,6271224.19
6669,17,700000,6928,6960,8061,32,159.56,1614143.0049603174,6271224.19
6670,17,900000,6928,6959,7130,31,159.56,1614143.0049603174,6271224.19
6671,21,900000,6931,7043,7387,112,159.56,17091199.984,6271224.19
6672,15,550000,6932,6959,7283,27,159.56,4522577.48037889,6271224.19
6673,16,1200000,6933,6952,8691,19,159.56,2465023.1840707962,6271224.19
6674,22,675000,6933,6983,7306,50,159.56,2904103.2512077293,6271224.19
6675,22,675000,6933,6983,7306,50,159.56,2904103.2512077293,6271224.19
6676,2,800000,6933,6998,8004,65,159.56,2989003.2716499544,6271224.19
6677,23,600000,6934,6953,7691,19,159.56,5772926.70157068,6271224.19
6678,16,850000,6935,6948,7372,13,159.56,2465023.1840707962,6271224.19
6679,18,736000,6935,6968,7691,33,159.56,8584355.493548388,6271224.19
6680,17,900000,6935,7005,7372,70,159.56,1614143.0049603174,6271224.19
6681,3,1400000,6935,7113,7731,178,159.56,9246769.549865229,6271224.19
6682,15,600000,6936,7102,8436,166,159.56,4522577.48037889,6271224.19
6683,2,880000,6936,6990,7935,54,159.56,2989003.2716499544,6271224.19
6684,17,900000,6938,6994,7606,56,159.56,1614143.0049603174,6271224.19
6685,24,1000000,6938,6975,7110,37,159.56,23456062.532786883,6271224.19
6686,6,600000,6938,6955,8289,17,159.56,1124713.2781954887,6271224.19
6687,11,1500000,6939,6981,7766,42,159.56,1820371.57,6271224.19
6688,16,680000,6939,6961,8380,22,159.56,2465023.1840707962,6271224.19
6689,16,660000,6939,6961,8380,22,159.56,2465023.1840707962,6271224.19
6690,12,1500000,6939,6988,7789,49,159.56,7658937.101338432,6271224.19
6691,18,800000,6940,6966,7418,26,159.56,8584355.493548388,6271224.19
6692,24,1000000,6941,6977,7271,36,159.56,23456062.532786883,6271224.19
6693,15,700000,6942,6974,7792,32,159.56,4522577.48037889,6271224.19
6694,16,800000,6942,7053,7562,111,159.56,2465023.1840707962,6271224.19
6695,12,700000,6942,6968,7339,26,159.56,7658937.101338432,6271224.19
6696,2,759500,6946,6961,8864,15,159.56,2989003.2716499544,6271224.19
6697,17,950000,6946,6961,7787,15,159.56,1614143.0049603174,6271224.19
6698,2,800000,6947,7002,7712,55,159.56,2989003.2716499544,6271224.19
6699,11,700000,6947,6967,7464,20,159.56,1820371.57,6271224.19
6700,2,750000,6947,6960,8174,13,159.56,2989003.2716499544,6271224.19
6701,17,850000,6948,6967,7828,19,159.56,1614143.0049603174,6271224.19
6702,1,800000,6948,6966,7410,18,159.56,3325419.7044334975,6271224.19
6703,12,1000000,6948,6981,8332,33,159.56,7658937.101338432,6271224.19
6704,16,625000,6949,7228,8380,279,159.56,2465023.1840707962,6271224.19
6705,16,600000,6949,7172,8384,223,159.56,2465023.1840707962,6271224.19
6706,15,600000,6952,7102,8436,150,159.56,4522577.48037889,6271224.19
6707,2,750000,6953,6963,7358,10,159.56,2989003.2716499544,6271224.19
6708,17,1500000,6953,7047,8607,94,159.56,1614143.0049603174,6271224.19
6709,13,1000000,6953,7179,8103,226,159.56,7795654.71978022,6271224.19
6710,16,600000,6953,6967,8688,14,159.56,2465023.1840707962,6271224.19
6711,18,900000,6953,6980,7834,27,159.56,8584355.493548388,6271224.19
6712,12,3000000,6953,7001,8074,48,159.56,7658937.101338432,6271224.19
6713,11,900000,6954,7054,7662,100,159.56,1820371.57,6271224.19
6714,4,750000,6955,6980,7592,25,159.56,4297914.794871795,6271224.19
6715,3,1200000,6959,6966,7275,7,159.56,9246769.549865229,6271224.19
6716,6,900000,6960,7214,7698,254,159.56,1124713.2781954887,6271224.19
6717,1,600000,6960,6989,7528,29,159.56,3325419.7044334975,6271224.19
6718,3,4000000,6961,6997,8277,36,159.56,9246769.549865229,6271224.19
6719,17,2000000,6961,7010,7766,49,159.56,1614143.0049603174,6271224.19
6720,19,1000000,6962,7033,7834,71,159.56,6721340.5708154505,6271224.19
6721,19,850000,6962,7061,7704,99,159.56,6721340.5708154505,6271224.19
6722,16,1300000,6963,6974,7858,11,159.56,2465023.1840707962,6271224.19
6723,2,800000,6966,7025,7841,59,159.56,2989003.2716499544,6271224.19
6724,18,800000,6966,7009,7591,43,159.56,8584355.493548388,6271224.19
6725,21,1100000,6966,6970,7178,4,159.56,17091199.984,6271224.19
6726,11,750000,6969,6984,7540,15,159.56,1820371.57,6271224.19
6727,17,1550000,6970,7053,7695,83,159.56,1614143.0049603174,6271224.19
6728,11,800000,6970,6988,7708,18,159.56,1820371.57,6271224.19
6729,5,600000,6973,6996,7499,23,159.56,1400922.5020242915,6271224.19
6730,9,900000,6975,7051,7565,76,159.56,3707403.8834951455,6271224.19
6731,2,1000000,6976,7059,8262,83,159.56,2989003.2716499544,6271224.19
6732,24,600000,6976,7003,7256,27,159.56,23456062.532786883,6271224.19
6733,2,850000,6980,7127,8761,147,159.56,2989003.2716499544,6271224.19
6734,13,1000000,6981,7089,7625,108,159.56,7795654.71978022,6271224.19
6735,17,850000,6981,6995,7683,14,159.56,1614143.0049603174,6271224.19
6736,15,800000,6982,7015,7688,33,159.56,4522577.48037889,6271224.19
6737,2,785000,6982,7145,8279,163,159.56,2989003.2716499544,6271224.19
6738,22,750000,6983,7338,7662,355,159.56,2904103.2512077293,6271224.19
6739,21,120000000,6983,7369,8522,386,159.56,17091199.984,6271224.19
6740,4,600000,6987,7180,7739,193,159.56,4297914.794871795,6271224.19
6741,21,750000,6987,7008,7197,21,159.56,17091199.984,6271224.19
6742,4,600000,6987,7184,7739,197,159.56,4297914.794871795,6271224.19
6743,11,750000,6988,7005,7701,17,159.56,1820371.57,6271224.19
6744,14,565000,6988,6998,8363,10,159.56,5826416.914893617,6271224.19
6745,12,1500000,6989,7010,7817,21,159.56,7658937.101338432,6271224.19
6746,15,800000,6989,7008,7665,19,159.56,4522577.48037889,6271224.19
6747,23,1200000,6991,7039,7361,48,159.56,5772926.70157068,6271224.19
6748,15,575000,6991,7018,7283,27,159.56,4522577.48037889,6271224.19
6749,2,800000,6991,7059,8615,68,159.56,2989003.2716499544,6271224.19
6750,17,700000,6994,7012,7764,18,159.56,1614143.0049603174,6271224.19
6751,9,800000,6996,7284,8095,288,159.56,3707403.8834951455,6271224.19
6752,15,750000,6996,7120,7695,124,159.56,4522577.48037889,6271224.19
6753,11,600000,6997,7017,7821,20,159.56,1820371.57,6271224.19
6754,12,1000000,7001,7066,8174,65,159.56,7658937.101338432,6271224.19
6755,15,800000,7001,7074,7659,73,159.56,4522577.48037889,6271224.19
6756,21,720000,7002,7016,7178,14,159.56,17091199.984,6271224.19
6757,23,1000000,7004,7019,8249,15,159.56,5772926.70157068,6271224.19
6758,21,2300000,7009,7044,7325,35,159.56,17091199.984,6271224.19
6759,2,800000,7010,7038,7618,28,159.56,2989003.2716499544,6271224.19
6760,2,600000,7010,7166,7884,156,159.56,2989003.2716499544,6271224.19
6761,9,560000,7011,7057,7933,46,159.56,3707403.8834951455,6271224.19
6762,10,800000,7017,7124,7885,107,159.56,8282326.220930233,6271224.19
6763,15,50000000,7017,7946,8870,929,159.56,4522577.48037889,6271224.19
6764,16,980000,7018,7066,7865,48,159.56,2465023.1840707962,6271224.19
6765,16,980000,7018,7067,7865,49,159.56,2465023.1840707962,6271224.19
6766,1,750000,7018,7065,8846,47,159.56,3325419.7044334975,6271224.19
6767,11,750000,7019,7046,7382,27,159.56,1820371.57,6271224.19
6768,3,600000,7019,7124,7305,105,159.56,9246769.549865229,6271224.19
6769,2,800000,7019,7061,7312,42,159.56,2989003.2716499544,6271224.19
6770,2,1500000,7021,7043,7689,22,159.56,2989003.2716499544,6271224.19
6771,15,850000,7025,7127,8005,102,159.56,4522577.48037889,6271224.19
6772,11,700000,7026,7085,8264,59,159.56,1820371.57,6271224.19
6773,9,750000,7026,7082,8523,56,159.56,3707403.8834951455,6271224.19
6774,17,900000,7031,7072,8768,41,155.74,1614143.0049603174,6918446.56
6775,1,700000,7039,7068,7712,29,155.74,3325419.7044334975,6918446.56
6776,15,550000,7039,7057,7737,18,155.74,4522577.48037889,6918446.56
6777,24,46767000,7040,7844,8697,804,155.74,23456062.532786883,6918446.56
6778,24,44111000,7040,7844,8697,804,155.74,23456062.532786883,6918446.56
6779,10,590610,7043,7148,7977,105,155.74,8282326.220930233,6918446.56
6780,22,700000,7043,7082,7436,39,155.74,2904103.2512077293,6918446.56
6781,16,625000,7044,7059,7765,15,155.74,2465023.1840707962,6918446.56
6782,11,900000,7045,7089,7627,44,155.74,1820371.57,6918446.56
6783,5,750000,7046,7109,7542,63,155.74,1400922.5020242915,6918446.56
6784,5,750000,7046,7109,7542,63,155.74,1400922.5020242915,6918446.56
6785,17,600000,7047,7066,7295,19,155.74,1614143.0049603174,6918446.56
6786,17,750000,7053,7107,7292,54,155.74,1614143.0049603174,6918446.56
6787,16,682000,7053,7074,7579,21,155.74,2465023.1840707962,6918446.56
6788,17,1000000,7054,7074,7820,20,155.74,1614143.0049603174,6918446.56
6789,19,900000,7054,7178,7588,124,155.74,6721340.5708154505,6918446.56
6790,22,800000,7058,7127,7635,69,155.74,2904103.2512077293,6918446.56
6791,16,1500000,7058,7134,7869,76,155.74,2465023.1840707962,6918446.56
6792,16,1500000,7058,7134,7820,76,155.74,2465023.1840707962,6918446.56
6793,17,650000,7059,7143,8101,84,155.74,1614143.0049603174,6918446.56
6794,11,800000,7060,7172,8767,112,155.74,1820371.57,6918446.56
6795,23,4700000,7060,7569,8027,509,155.74,5772926.70157068,6918446.56
6796,24,600000,7060,7075,8290,15,155.74,23456062.532786883,6918446.56
6797,16,560000,7061,7075,8529,14,155.74,2465023.1840707962,6918446.56
6798,15,600000,7064,7089,8017,25,155.74,4522577.48037889,6918446.56
6799,24,1300000,7064,7080,7200,16,155.74,23456062.532786883,6918446.56
6800,15,850000,7065,7093,7828,28,155.74,4522577.48037889,6918446.56
6801,10,750000,7065,7122,7731,57,155.74,8282326.220930233,6918446.56
6802,16,1000000,7068,7108,8712,40,155.74,2465023.1840707962,6918446.56
6803,3,1191500,7068,7102,8277,34,155.74,9246769.549865229,6918446.56
6804,12,2000000,7068,7085,8690,17,155.74,7658937.101338432,6918446.56
6805,6,900000,7071,7173,7691,102,155.74,1124713.2781954887,6918446.56
6806,16,785000,7072,7086,8461,14,155.74,2465023.1840707962,6918446.56
6807,14,2000000,7074,7106,7493,32,155.74,5826416.914893617,6918446.56
6808,2,2000000,7075,7134,7866,59,155.74,2989003.2716499544,6918446.56
6809,11,750000,7079,7095,7551,16,155.74,1820371.57,6918446.56
6810,24,1500000,7080,7121,7681,41,155.74,23456062.532786883,6918446.56
6811,11,700000,7080,7171,8157,91,155.74,1820371.57,6918446.56
6812,9,600000,7085,7107,7606,22,155.74,3707403.8834951455,6918446.56
6813,18,660000,7085,7106,7374,21,155.74,8584355.493548388,6918446.56
6814,15,600000,7086,7142,8149,56,155.74,4522577.48037889,6918446.56
6815,16,800000,7086,7109,7547,23,155.74,2465023.1840707962,6918446.56
6816,16,800000,7092,7117,7584,25,155.74,2465023.1840707962,6918446.56
6817,15,900000,7093,7142,7679,49,155.74,4522577.48037889,6918446.56
6818,17,1550000,7095,7120,7688,25,155.74,1614143.0049603174,6918446.56
6819,5,600000,7096,7135,7687,39,155.74,1400922.5020242915,6918446.56
6820,6,800000,7096,7190,7726,94,155.74,1124713.2781954887,6918446.56
6821,5,600000,7096,7135,7687,39,155.74,1400922.5020242915,6918446.56
6822,18,1100000,7096,7535,8416,439,155.74,8584355.493548388,6918446.56
6823,22,650000,7099,7128,7599,29,155.74,2904103.2512077293,6918446.56
6824,11,900000,7099,7145,7876,46,155.74,1820371.57,6918446.56
6825,3,600000,7099,7113,7330,14,155.74,9246769.549865229,6918446.56
6826,12,796000,7100,7130,7668,30,155.74,7658937.101338432,6918446.56
6827,16,850000,7100,7117,8326,17,155.74,2465023.1840707962,6918446.56
6828,1,1000000,7100,7113,7689,13,155.74,3325419.7044334975,6918446.56
6829,17,1200000,7101,7128,8389,27,155.74,1614143.0049603174,6918446.56
6830,15,1000000,7101,7143,7666,42,155.74,4522577.48037889,6918446.56
6831,15,700000,7102,7135,7719,33,155.74,4522577.48037889,6918446.56
6832,24,900000,7103,7136,7305,33,155.74,23456062.532786883,6918446.56
6833,21,900000,7103,7208,7901,105,155.74,17091199.984,6918446.56
6834,15,600000,7106,7124,7691,18,155.74,4522577.48037889,6918446.56
6835,24,750000,7107,7117,7956,10,155.74,23456062.532786883,6918446.56
6836,17,1000000,7107,7165,7530,58,155.74,1614143.0049603174,6918446.56
6837,2,985000,7107,7186,7962,79,155.74,2989003.2716499544,6918446.56
6838,16,800000,7107,7129,8549,22,155.74,2465023.1840707962,6918446.56
6839,17,1000000,7108,7123,7955,15,155.74,1614143.0049603174,6918446.56
6840,12,1000000,7108,7131,8823,23,155.74,7658937.101338432,6918446.56
6841,11,1800000,7109,7152,8684,43,155.74,1820371.57,6918446.56
6842,4,600000,7109,7130,7739,21,155.74,4297914.794871795,6918446.56
6843,12,950000,7109,7186,8040,77,155.74,7658937.101338432,6918446.56
6844,2,750000,7109,7131,7884,22,155.74,2989003.2716499544,6918446.56
6845,3,700000,7113,7235,7957,122,155.74,9246769.549865229,6918446.56
6846,24,3500000,7114,7144,7460,30,155.74,23456062.532786883,6918446.56
6847,2,1277872,7116,7131,7730,15,155.74,2989003.2716499544,6918446.56
6848,15,750000,7117,7148,8111,31,155.74,4522577.48037889,6918446.56
6849,17,1000000,7117,7172,7310,55,155.74,1614143.0049603174,6918446.56
6850,0,650000,7120,7206,7718,86,155.74,8418173.322222222,6918446.56
6851,19,600000,7121,7271,7870,150,155.74,6721340.5708154505,6918446.56
6852,11,700000,7121,7143,7627,22,155.74,1820371.57,6918446.56
6853,11,1500000,7122,7143,8405,21,155.74,1820371.57,6918446.56
6854,23,700000,7122,7142,7675,20,155.74,5772926.70157068,6918446.56
6855,17,1000000,7122,7158,8110,36,155.74,1614143.0049603174,6918446.56
6856,17,2000000,7123,7164,7998,41,155.74,1614143.0049603174,6918446.56
6857,23,1000000,7123,7151,7724,28,155.74,5772926.70157068,6918446.56
6858,3,750000,7124,7158,7284,34,155.74,9246769.549865229,6918446.56
6859,11,1000000,7124,7144,7785,20,155.74,1820371.57,6918446.56
6860,15,700000,7124,7145,7620,21,155.74,4522577.48037889,6918446.56
6861,6,900000,7124,7173,7990,49,155.74,1124713.2781954887,6918446.56
6862,22,650000,7128,7142,7711,14,155.74,2904103.2512077293,6918446.56
6863,2,700000,7129,7233,8025,104,155.74,2989003.2716499544,6918446.56
6864,12,800000,7130,7201,7837,71,155.74,7658937.101338432,6918446.56
6865,0,600000,7130,7162,8034,32,155.74,8418173.322222222,6918446.56
6866,11,2000000,7130,7205,7905,75,155.74,1820371.57,6918446.56
6867,4,1000000,7130,7150,8303,20,155.74,4297914.794871795,6918446.56
6868,17,5000000,7131,7150,8670,19,155.74,1614143.0049603174,6918446.56
6869,1,600000,7131,7190,7828,59,155.74,3325419.7044334975,6918446.56
6870,13,69000000,7131,7857,8881,726,155.74,7795654.71978022,6918446.56
6871,17,1000000,7131,7186,8401,55,155.74,1614143.0049603174,6918446.56
6872,18,600000,7134,7166,7731,32,155.74,8584355.493548388,6918446.56
6873,15,1700000,7135,7526,8082,391,155.74,4522577.48037889,6918446.56
6874,15,800000,7142,7156,7605,14,155.74,4522577.48037889,6918446.56
6875,1,750000,7144,7158,7695,14,155.74,3325419.7044334975,6918446.56
6876,17,600000,7144,7239,8335,95,155.74,1614143.0049603174,6918446.56
6877,12,750000,7145,7177,7690,32,155.74,7658937.101338432,6918446.56
6878,5,800000,7145,7218,8131,73,155.74,1400922.5020242915,6918446.56
6879,4,1000000,7145,7199,8320,54,155.74,4297914.794871795,6918446.56
6880,17,700000,7145,7199,7726,54,155.74,1614143.0049603174,6918446.56
6881,12,544000,7148,7170,7947,22,155.74,7658937.101338432,6918446.56
6882,13,15200000,7149,7893,8494,744,155.74,7795654.71978022,6918446.56
6883,2,750000,7149,7180,8068,31,155.74,2989003.2716499544,6918446.56
6884,22,600000,7151,7332,7606,181,155.74,2904103.2512077293,6918446.56
6885,2,2500000,7151,7213,8107,62,155.74,2989003.2716499544,6918446.56
6886,12,2000000,7152,7191,7940,39,155.74,7658937.101338432,6918446.56
6887,1,600000,7156,7184,7785,28,155.74,3325419.7044334975,6918446.56
6888,12,1500000,7156,7197,8401,41,155.74,7658937.101338432,6918446.56
6889,5,800000,7157,7208,8150,51,155.74,1400922.5020242915,6918446.56
6890,5,800000,7157,7208,8388,51,155.74,1400922.5020242915,6918446.56
6891,1,1500000,7158,7193,8068,35,155.74,3325419.7044334975,6918446.56
6892,17,800000,7158,7240,7589,82,155.74,1614143.0049603174,6918446.56
6893,18,550000,7158,7199,7638,41,155.74,8584355.493548388,6918446.56
6894,3,2200000,7159,7176,7584,17,155.74,9246769.549865229,6918446.56
6895,12,900000,7159,7184,7961,25,155.74,7658937.101338432,6918446.56
6896,2,850000,7160,7218,7991,58,155.74,2989003.2716499544,6918446.56
6897,11,20000000,7162,7717,8823,555,155.74,1820371.57,6918446.56
6898,0,1303500,7162,7242,7691,80,155.74,8418173.322222222,6918446.56
6899,13,1100000,7163,7171,7367,8,155.74,7795654.71978022,6918446.56
6900,3,900000,7163,7197,7661,34,155.74,9246769.549865229,6918446.56
6901,11,660000,7163,7215,7808,52,155.74,1820371.57,6918446.56
6902,23,15000000,7164,7813,8821,649,155.74,5772926.70157068,6918446.56
6903,15,700000,7165,7197,7695,32,155.74,4522577.48037889,6918446.56
6904,15,600000,7166,7212,7753,46,155.74,4522577.48037889,6918446.56
6905,24,2000000,7166,7199,7407,33,155.74,23456062.532786883,6918446.56
6906,15,700000,7167,7275,8108,108,155.74,4522577.48037889,6918446.56
6907,23,600000,7170,7215,7869,45,155.74,5772926.70157068,6918446.56
6908,15,600000,7172,7207,7613,35,155.74,4522577.48037889,6918446.56
6909,17,2000000,7172,7241,8292,69,155.74,1614143.0049603174,6918446.56
6910,2,1000000,7179,7194,8109,15,155.74,2989003.2716499544,6918446.56
6911,1,750000,7180,7198,7844,18,155.74,3325419.7044334975,6918446.56
6912,2,750000,7183,7247,8241,64,155.74,2989003.2716499544,6918446.56
6913,17,750000,7184,7201,8503,17,155.74,1614143.0049603174,6918446.56
6914,15,600000,7185,7289,8004,104,155.74,4522577.48037889,6918446.56
6915,11,1000000,7185,7261,8368,76,155.74,1820371.57,6918446.56
6916,13,1000000,7186,7267,8006,81,155.74,7795654.71978022,6918446.56
6917,16,1000000,7191,7229,7733,38,155.74,2465023.1840707962,6918446.56
6918,15,800000,7192,7225,7617,33,155.74,4522577.48037889,6918446.56
6919,15,800000,7192,7228,7617,36,155.74,4522577.48037889,6918446.56
6920,15,800000,7192,7268,7717,76,155.74,4522577.48037889,6918446.56
6921,17,900000,7193,7212,8313,19,155.74,1614143.0049603174,6918446.56
6922,16,850000,7196,7281,8382,85,155.74,2465023.1840707962,6918446.56
6923,15,700000,7197,7242,7683,45,155.74,4522577.48037889,6918446.56
6924,15,745000,7198,7254,7760,56,155.74,4522577.48037889,6918446.56
6925,16,675000,7199,7247,8384,48,155.74,2465023.1840707962,6918446.56
6926,16,650000,7199,7247,8389,48,155.74,2465023.1840707962,6918446.56
6927,2,850000,7199,7214,7730,15,155.74,2989003.2716499544,6918446.56
6928,16,600000,7199,7247,8389,48,155.74,2465023.1840707962,6918446.56
6929,21,700000,7199,7220,7878,21,155.74,17091199.984,6918446.56
6930,16,600000,7199,7247,8389,48,155.74,2465023.1840707962,6918446.56
6931,16,600000,7199,7247,8389,48,155.74,2465023.1840707962,6918446.56
6932,16,650000,7199,7247,8389,48,155.74,2465023.1840707962,6918446.56
6933,17,750000,7199,7222,8641,23,155.74,1614143.0049603174,6918446.56
6934,15,900000,7200,7225,7984,25,155.74,4522577.48037889,6918446.56
6935,17,1500000,7200,7225,7802,25,155.74,1614143.0049603174,6918446.56
6936,17,900000,7201,7232,8059,31,155.74,1614143.0049603174,6918446.56
6937,19,650000,7204,7330,7752,126,155.74,6721340.5708154505,6918446.56
6938,15,1000000,7206,7263,7892,57,155.74,4522577.48037889,6918446.56
6939,15,1000000,7206,7268,7898,62,155.74,4522577.48037889,6918446.56
6940,1,800000,7206,7235,7815,29,155.74,3325419.7044334975,6918446.56
6941,10,860000,7206,7599,8289,393,155.74,8282326.220930233,6918446.56
6942,18,1000000,7206,7318,8646,112,155.74,8584355.493548388,6918446.56
6943,2,800000,7207,7261,8655,54,155.74,2989003.2716499544,6918446.56
6944,15,750000,7208,7256,8864,48,155.74,4522577.48037889,6918446.56
6945,12,1000000,7208,7302,8439,94,155.74,7658937.101338432,6918446.56
6946,16,1200000,7212,7227,7932,15,155.74,2465023.1840707962,6918446.56
6947,15,740000,7214,7260,7660,46,155.74,4522577.48037889,6918446.56
6948,17,1000000,7215,7240,8424,25,155.74,1614143.0049603174,6918446.56
6949,16,790000,7218,7291,8389,73,155.74,2465023.1840707962,6918446.56
6950,17,1000000,7218,7235,7894,17,155.74,1614143.0049603174,6918446.56
6951,16,600000,7218,7247,8389,29,155.74,2465023.1840707962,6918446.56
6952,16,600000,7219,7247,8389,28,155.74,2465023.1840707962,6918446.56
6953,16,600000,7219,7247,8389,28,155.74,2465023.1840707962,6918446.56
6954,16,680000,7219,7247,8389,28,155.74,2465023.1840707962,6918446.56
6955,16,600000,7219,7247,8389,28,155.74,2465023.1840707962,6918446.56
6956,16,600000,7219,7247,8422,28,155.74,2465023.1840707962,6918446.56
6957,16,680000,7219,7247,8389,28,155.74,2465023.1840707962,6918446.56
6958,11,550000,7219,7283,8747,64,155.74,1820371.57,6918446.56
6959,16,600000,7220,7247,8389,27,155.74,2465023.1840707962,6918446.56
6960,16,650000,7220,7247,8389,27,155.74,2465023.1840707962,6918446.56
6961,16,600000,7220,7247,8389,27,155.74,2465023.1840707962,6918446.56
6962,16,600000,7220,7247,8389,27,155.74,2465023.1840707962,6918446.56
6963,3,1225000,7220,7250,8100,30,155.74,9246769.549865229,6918446.56
6964,12,1000000,7220,7257,8331,37,155.74,7658937.101338432,6918446.56
6965,16,600000,7220,7247,8390,27,155.74,2465023.1840707962,6918446.56
6966,17,900000,7220,7256,7893,36,155.74,1614143.0049603174,6918446.56
6967,15,600000,7221,7352,8716,131,155.74,4522577.48037889,6918446.56
6968,17,700000,7221,7236,8454,15,155.74,1614143.0049603174,6918446.56
6969,11,750000,7222,7236,7759,14,155.74,1820371.57,6918446.56
6970,2,800000,7222,7247,7717,25,155.74,2989003.2716499544,6918446.56
6971,11,5000000,7225,7386,8306,161,155.74,1820371.57,6918446.56
6972,23,800000,7225,7257,8033,32,155.74,5772926.70157068,6918446.56
6973,18,850000,7226,7418,8604,192,155.74,8584355.493548388,6918446.56
6974,9,1000000,7226,7296,8838,70,155.74,3707403.8834951455,6918446.56
6975,15,1000000,7227,7270,7619,43,155.74,4522577.48037889,6918446.56
6976,17,1000000,7227,7239,8114,12,155.74,1614143.0049603174,6918446.56
6977,15,600000,7228,7255,7848,27,155.74,4522577.48037889,6918446.56
6978,15,600000,7228,7255,7827,27,155.74,4522577.48037889,6918446.56
6979,20,950000,7228,7264,7656,36,155.74,7597088.421768707,6918446.56
6980,15,900000,7232,7263,8825,31,155.74,4522577.48037889,6918446.56
6981,17,800000,7232,7341,7949,109,155.74,1614143.0049603174,6918446.56
6982,15,700000,7232,7257,7631,25,155.74,4522577.48037889,6918446.56
6983,2,8000000,7233,7250,8097,17,155.74,2989003.2716499544,6918446.56
6984,22,700000,7233,7283,8185,50,155.74,2904103.2512077293,6918446.56
6985,17,1000000,7234,7254,8089,20,155.74,1614143.0049603174,6918446.56
6986,17,650000,7234,7242,7690,8,155.74,1614143.0049603174,6918446.56
6987,13,47000000,7235,7915,8685,680,155.74,7795654.71978022,6918446.56
6988,12,4000000,7235,7277,8034,42,155.74,7658937.101338432,6918446.56
6989,12,1000000,7235,7309,8530,74,155.74,7658937.101338432,6918446.56
6990,15,650000,7236,7661,8300,425,155.74,4522577.48037889,6918446.56
6991,12,2500000,7239,7324,8436,85,155.74,7658937.101338432,6918446.56
6992,3,575000,7239,7247,7733,8,155.74,9246769.549865229,6918446.56
6993,4,600000,7240,7310,8530,70,155.74,4297914.794871795,6918446.56
6994,17,800000,7241,7267,7749,26,155.74,1614143.0049603174,6918446.56
6995,2,900000,7242,7332,8129,90,155.74,2989003.2716499544,6918446.56
6996,11,2000000,7242,7429,8417,187,155.74,1820371.57,6918446.56
6997,23,800000,7243,7277,7970,34,155.74,5772926.70157068,6918446.56
6998,2,900000,7243,7332,8545,89,155.74,2989003.2716499544,6918446.56
6999,15,1500000,7243,7325,7949,82,155.74,4522577.48037889,6918446.56
7000,18,900000,7243,7267,8726,24,155.74,8584355.493548388,6918446.56
7001,10,600000,7243,7276,7771,33,155.74,8282326.220930233,6918446.56
7002,18,900000,7247,7283,8907,36,155.74,8584355.493548388,6918446.56
7003,1,800000,7247,7269,7612,22,155.74,3325419.7044334975,6918446.56
7004,9,8100000,7248,7418,7859,170,155.74,3707403.8834951455,6918446.56
7005,23,1000000,7249,7304,8145,55,155.74,5772926.70157068,6918446.56
7006,17,1200000,7253,7267,7941,14,155.74,1614143.0049603174,6918446.56
7007,17,700000,7253,7330,7849,77,155.74,1614143.0049603174,6918446.56
7008,11,750000,7253,7319,8054,66,155.74,1820371.57,6918446.56
7009,23,600000,7253,7443,8656,190,155.74,5772926.70157068,6918446.56
7010,24,6000000,7254,7283,7688,29,155.74,23456062.532786883,6918446.56
7011,21,750000,7255,7284,7816,29,155.74,17091199.984,6918446.56
7012,15,900000,7257,7312,8027,55,155.74,4522577.48037889,6918446.56
7013,16,1100000,7257,7284,7988,27,155.74,2465023.1840707962,6918446.56
7014,21,990000,7257,7288,7614,31,155.74,17091199.984,6918446.56
7015,5,608000,7260,7360,8779,100,155.74,1400922.5020242915,6918446.56
7016,17,1000000,7260,7276,7693,16,155.74,1614143.0049603174,6918446.56
7017,15,600000,7260,7291,7824,31,155.74,4522577.48037889,6918446.56
7018,17,1100000,7261,7281,8410,20,155.74,1614143.0049603174,6918446.56
7019,2,650000,7261,7306,8727,45,155.74,2989003.2716499544,6918446.56
7020,2,650000,7262,7306,8727,44,155.74,2989003.2716499544,6918446.56
7021,15,630000,7262,7289,8011,27,155.74,4522577.48037889,6918446.56
7022,23,600000,7262,7281,8466,19,155.74,5772926.70157068,6918446.56
7023,23,600000,7262,7297,8145,35,155.74,5772926.70157068,6918446.56
7024,20,600000,7262,7319,7614,57,155.74,7597088.421768707,6918446.56
7025,22,580000,7267,7291,7998,24,155.74,2904103.2512077293,6918446.56
7026,16,650000,7268,7291,8405,23,155.74,2465023.1840707962,6918446.56
7027,17,650000,7268,7283,7789,15,155.74,1614143.0049603174,6918446.56
7028,16,650000,7268,7291,8405,23,155.74,2465023.1840707962,6918446.56
7029,24,1900000,7268,7288,7661,20,155.74,23456062.532786883,6918446.56
7030,16,830000,7268,7295,8412,27,155.74,2465023.1840707962,6918446.56
7031,11,1000000,7270,7324,8500,54,155.74,1820371.57,6918446.56
7032,17,900000,7270,7283,7454,13,155.74,1614143.0049603174,6918446.56
7033,15,850000,7270,7340,8058,70,155.74,4522577.48037889,6918446.56
7034,11,1200000,7270,7345,7939,75,155.74,1820371.57,6918446.56
7035,17,800000,7272,7305,7962,33,155.74,1614143.0049603174,6918446.56
7036,24,800000,7276,7367,7675,91,155.74,23456062.532786883,6918446.56
7037,15,600000,7277,7457,8129,180,155.74,4522577.48037889,6918446.56
7038,12,700000,7278,7297,8272,19,155.74,7658937.101338432,6918446.56
7039,2,1200000,7281,7310,7914,29,155.74,2989003.2716499544,6918446.56
7040,3,2000000,7281,7283,7696,2,155.74,9246769.549865229,6918446.56
7041,20,1400000,7284,7330,7744,46,155.74,7597088.421768707,6918446.56
7042,17,1000000,7284,7319,7947,35,155.74,1614143.0049603174,6918446.56
7043,2,800000,7285,7303,8067,18,155.74,2989003.2716499544,6918446.56
7044,16,900000,7285,7339,8692,54,155.74,2465023.1840707962,6918446.56
7045,15,600000,7288,7310,7865,22,155.74,4522577.48037889,6918446.56
7046,17,700000,7290,7330,8011,40,155.74,1614143.0049603174,6918446.56
7047,15,800000,7291,7326,8699,35,155.74,4522577.48037889,6918446.56
7048,15,1300000,7292,7304,8060,12,155.74,4522577.48037889,6918446.56
7049,2,750000,7295,7374,8150,79,155.74,2989003.2716499544,6918446.56
7050,13,1000000,7295,7312,8346,17,155.74,7795654.71978022,6918446.56
7051,10,700000,7297,7459,8461,162,155.74,8282326.220930233,6918446.56
7052,18,800000,7297,7634,8548,337,155.74,8584355.493548388,6918446.56
7053,2,900000,7298,7341,8080,43,155.74,2989003.2716499544,6918446.56
7054,2,950000,7298,7327,7844,29,155.74,2989003.2716499544,6918446.56
7055,15,750000,7299,7310,7823,11,155.74,4522577.48037889,6918446.56
7056,16,650000,7300,7317,7919,17,155.74,2465023.1840707962,6918446.56
7057,17,1000000,7302,7323,8114,21,155.74,1614143.0049603174,6918446.56
7058,2,600000,7302,7323,8521,21,155.74,2989003.2716499544,6918446.56
7059,24,1985550,7305,7338,8081,33,155.74,23456062.532786883,6918446.56
7060,15,800000,7305,7360,7963,55,155.74,4522577.48037889,6918446.56
7061,19,1250000,7305,7337,8235,32,155.74,6721340.5708154505,6918446.56
7062,16,1300000,7305,7358,8040,53,155.74,2465023.1840707962,6918446.56
7063,16,600000,7306,7423,8255,117,155.74,2465023.1840707962,6918446.56
7064,17,600000,7311,7337,8527,26,155.74,1614143.0049603174,6918446.56
7065,21,600000,7311,7341,7648,30,155.74,17091199.984,6918446.56
7066,17,600000,7312,7330,7941,18,155.74,1614143.0049603174,6918446.56
7067,5,600000,7319,7375,8300,56,155.74,1400922.5020242915,6918446.56
7068,16,675000,7319,7341,8802,22,155.74,2465023.1840707962,6918446.56
7069,16,800000,7319,7337,8838,18,155.74,2465023.1840707962,6918446.56
7070,10,937000,7319,7530,8611,211,155.74,8282326.220930233,6918446.56
7071,5,600000,7320,7421,8584,101,155.74,1400922.5020242915,6918446.56
7072,3,1000000,7320,7375,7991,55,155.74,9246769.549865229,6918446.56
7073,16,650000,7320,7360,7794,40,155.74,2465023.1840707962,6918446.56
7074,16,1300000,7321,7502,8601,181,155.74,2465023.1840707962,6918446.56
7075,24,2000000,7324,7339,8157,15,155.74,23456062.532786883,6918446.56
7076,13,14664847,7325,7746,8634,421,155.74,7795654.71978022,6918446.56
7077,1,700000,7330,7373,8088,43,155.74,3325419.7044334975,6918446.56
7078,17,1168220,7332,7367,8037,35,155.74,1614143.0049603174,6918446.56
7079,17,1260000,7332,7453,8864,121,155.74,1614143.0049603174,6918446.56
7080,8,750000,7332,7505,8006,173,155.74,1501617.2191780822,6918446.56
7081,12,1000000,7332,7353,7771,21,155.74,7658937.101338432,6918446.56
7082,17,1000000,7333,7359,7883,26,155.74,1614143.0049603174,6918446.56
7083,12,1000000,7333,7361,8037,28,155.74,7658937.101338432,6918446.56
7084,11,2000000,7337,7346,8425,9,155.74,1820371.57,6918446.56
7085,2,750000,7339,7362,8054,23,155.74,2989003.2716499544,6918446.56
7086,18,1000000,7339,7410,8646,71,155.74,8584355.493548388,6918446.56
7087,11,1400000,7341,7423,8552,82,155.74,1820371.57,6918446.56
7088,17,1000000,7341,7360,7851,19,155.74,1614143.0049603174,6918446.56
7089,2,525000,7347,7425,8597,78,155.74,2989003.2716499544,6918446.56
7090,11,750000,7347,7452,8514,105,155.74,1820371.57,6918446.56
7091,3,900000,7351,7376,7508,25,155.74,9246769.549865229,6918446.56
7092,16,670000,7352,7407,7864,55,155.74,2465023.1840707962,6918446.56
7093,16,670000,7352,7407,7864,55,155.74,2465023.1840707962,6918446.56
7094,24,1900000,7355,7383,8172,28,155.74,23456062.532786883,6918446.56
7095,4,1000000,7358,7430,8506,72,155.74,4297914.794871795,6918446.56
7096,7,550000,7360,7402,8024,42,155.74,3738553.685483871,6918446.56
7097,11,900000,7362,7400,7932,38,155.74,1820371.57,6918446.56
7098,15,550000,7365,7725,8237,360,155.74,4522577.48037889,6918446.56
7099,2,550000,7367,7453,8226,86,155.74,2989003.2716499544,6918446.56
7100,17,3900000,7367,7690,8402,323,155.74,1614143.0049603174,6918446.56
7101,11,720000,7367,7607,8012,240,155.74,1820371.57,6918446.56
7102,17,1000000,7372,7424,8094,52,155.74,1614143.0049603174,6918446.56
7103,19,700000,7373,7415,8017,42,155.74,6721340.5708154505,6918446.56
7104,12,880000,7373,7407,7430,34,155.74,7658937.101338432,6918446.56
7105,16,700000,7379,7387,7870,8,155.74,2465023.1840707962,6918446.56
7106,2,900000,7379,7458,8556,79,155.74,2989003.2716499544,6918446.56
7107,12,740000,7380,7390,7605,10,155.74,7658937.101338432,6918446.56
7108,17,1000000,7381,7464,8017,83,155.74,1614143.0049603174,6918446.56
7109,17,950000,7381,7439,8278,58,155.74,1614143.0049603174,6918446.56
7110,24,1850000,7383,7417,7892,34,155.74,23456062.532786883,6918446.56
7111,11,550000,7386,7583,8711,197,155.74,1820371.57,6918446.56
7112,3,1000000,7386,7438,7948,52,155.74,9246769.549865229,6918446.56
7113,3,1500000,7386,7470,8334,84,155.74,9246769.549865229,6918446.56
7114,12,30000000,7386,7900,8562,514,155.74,7658937.101338432,6918446.56
7115,11,884000,7387,7424,7969,37,155.74,1820371.57,6918446.56
7116,16,820000,7390,7407,8150,17,155.74,2465023.1840707962,6918446.56
7117,3,1000000,7396,7430,8412,34,152.24,9246769.549865229,6303424.81
7118,16,600000,7397,7451,8046,54,152.24,2465023.1840707962,6303424.81
7119,1,600000,7407,7421,8613,14,152.24,3325419.7044334975,6303424.81
7120,20,1500000,7407,8499,8836,1092,152.24,7597088.421768707,6303424.81
7121,5,600000,7408,7563,7879,155,152.24,1400922.5020242915,6303424.81
7122,5,600000,7408,7458,7933,50,152.24,1400922.5020242915,6303424.81
7123,13,1100000,7409,7435,7795,26,152.24,7795654.71978022,6303424.81
7124,18,2000000,7409,7561,8055,152,152.24,8584355.493548388,6303424.81
7125,16,1000000,7409,7535,8115,126,152.24,2465023.1840707962,6303424.81
7126,22,700000,7411,7471,8012,60,152.24,2904103.2512077293,6303424.81
7127,5,600000,7415,7523,7778,108,152.24,1400922.5020242915,6303424.81
7128,1,600000,7415,7534,7953,119,152.24,3325419.7044334975,6303424.81
7129,16,600000,7416,7458,7810,42,152.24,2465023.1840707962,6303424.81
7130,11,900000,7416,7449,7799,33,152.24,1820371.57,6303424.81
7131,6,1000000,7417,7446,8578,29,152.24,1124713.2781954887,6303424.81
7132,5,800000,7421,7841,8506,420,152.24,1400922.5020242915,6303424.81
7133,5,800000,7421,7845,8506,424,152.24,1400922.5020242915,6303424.81
7134,1,750000,7423,7579,8125,156,152.24,3325419.7044334975,6303424.81
7135,24,800000,7423,7541,8291,118,152.24,23456062.532786883,6303424.81
7136,2,1193375,7424,7458,8310,34,152.24,2989003.2716499544,6303424.81
7137,24,5000000,7424,7452,7667,28,152.24,23456062.532786883,6303424.81
7138,15,650000,7426,7634,8198,208,152.24,4522577.48037889,6303424.81
7139,15,650000,7426,7634,8198,208,152.24,4522577.48037889,6303424.81
7140,23,1000000,7428,7540,8069,112,152.24,5772926.70157068,6303424.81
7141,1,1010000,7430,7451,8158,21,152.24,3325419.7044334975,6303424.81
7142,11,750000,7431,7598,8739,167,152.24,1820371.57,6303424.81
7143,15,1400000,7433,7451,8086,18,152.24,4522577.48037889,6303424.81
7144,12,750000,7436,7452,8062,16,152.24,7658937.101338432,6303424.81
7145,2,800000,7436,7452,8255,16,152.24,2989003.2716499544,6303424.81
7146,16,850000,7438,7453,8257,15,152.24,2465023.1840707962,6303424.81
7147,10,750000,7439,7554,8732,115,152.24,8282326.220930233,6303424.81
7148,3,750000,7443,7459,8503,16,152.24,9246769.549865229,6303424.81
7149,9,650000,7443,7590,8446,147,152.24,3707403.8834951455,6303424.81
7150,19,502200,7445,7558,8005,113,152.24,6721340.5708154505,6303424.81
7151,17,600000,7445,7695,8892,250,152.24,1614143.0049603174,6303424.81
7152,18,1100000,7446,7514,8282,68,152.24,8584355.493548388,6303424.81
7153,6,600000,7446,7502,7989,56,152.24,1124713.2781954887,6303424.81
7154,3,900000,7446,7537,8020,91,152.24,9246769.549865229,6303424.81
7155,23,600000,7450,7494,7989,44,152.24,5772926.70157068,6303424.81
7156,17,720000,7451,7619,8270,168,152.24,1614143.0049603174,6303424.81
7157,11,1200000,7452,7530,8480,78,152.24,1820371.57,6303424.81
7158,12,630000,7452,7509,7696,57,152.24,7658937.101338432,6303424.81
7159,12,750000,7457,7471,7911,14,152.24,7658937.101338432,6303424.81
7160,7,1050000,7458,7537,8760,79,152.24,3738553.685483871,6303424.81
7161,18,1000000,7458,7530,8705,72,152.24,8584355.493548388,6303424.81
7162,1,1263300,7458,7519,8277,61,152.24,3325419.7044334975,6303424.81
7163,24,1600000,7459,7467,7702,8,152.24,23456062.532786883,6303424.81
7164,5,6470700,7460,8612,8895,1152,152.24,1400922.5020242915,6303424.81
7165,11,1100000,7463,7551,8422,88,152.24,1820371.57,6303424.81
7166,16,850000,7463,7515,8003,52,152.24,2465023.1840707962,6303424.81
7167,17,550000,7464,7528,8073,64,152.24,1614143.0049603174,6303424.81
7168,10,800000,7464,7549,8052,85,152.24,8282326.220930233,6303424.81
7169,9,1200000,7464,7501,8347,37,152.24,3707403.8834951455,6303424.81
7170,23,600000,7464,7512,8611,48,152.24,5772926.70157068,6303424.81
7171,17,650000,7465,7526,8034,61,152.24,1614143.0049603174,6303424.81
7172,18,1100000,7466,7499,8144,33,152.24,8584355.493548388,6303424.81
7173,17,700000,7466,7528,8045,62,152.24,1614143.0049603174,6303424.81
7174,24,2000000,7493,7529,8157,36,152.24,23456062.532786883,6303424.81
7175,3,1100000,7499,7589,8720,90,152.24,9246769.549865229,6303424.81
7176,0,1000000,7502,7520,8614,18,152.24,8418173.322222222,6303424.81
7177,15,600000,7502,7537,8451,35,152.24,4522577.48037889,6303424.81
7178,16,800000,7505,7541,7898,36,152.24,2465023.1840707962,6303424.81
7179,15,600000,7506,7543,7799,37,152.24,4522577.48037889,6303424.81
7180,12,700000,7508,7549,8095,41,152.24,7658937.101338432,6303424.81
7181,2,900000,7509,7526,8628,17,152.24,2989003.2716499544,6303424.81
7182,4,750000,7512,7557,8522,45,152.24,4297914.794871795,6303424.81
7183,4,750000,7512,7540,8010,28,152.24,4297914.794871795,6303424.81
7184,17,800000,7513,7569,8251,56,152.24,1614143.0049603174,6303424.81
7185,15,750000,7516,7597,8410,81,152.24,4522577.48037889,6303424.81
7186,12,3000000,7520,7572,8524,52,152.24,7658937.101338432,6303424.81
7187,2,800000,7521,7550,7978,29,152.24,2989003.2716499544,6303424.81
7188,10,700000,7521,7586,8731,65,152.24,8282326.220930233,6303424.81
7189,16,800000,7521,7562,8262,41,152.24,2465023.1840707962,6303424.81
7190,16,1200000,7523,7547,8209,24,152.24,2465023.1840707962,6303424.81
7191,17,850000,7527,7550,8058,23,152.24,1614143.0049603174,6303424.81
7192,4,700000,7527,7572,7950,45,152.24,4297914.794871795,6303424.81
7193,11,750000,7527,7638,8566,111,152.24,1820371.57,6303424.81
7194,17,600000,7528,7578,8058,50,152.24,1614143.0049603174,6303424.81
7195,13,550000,7528,7598,8179,70,152.24,7795654.71978022,6303424.81
7196,13,550000,7529,7550,8179,21,152.24,7795654.71978022,6303424.81
7197,2,900000,7529,7605,8907,76,152.24,2989003.2716499544,6303424.81
7198,17,625000,7535,7555,7781,20,152.24,1614143.0049603174,6303424.81
7199,15,550000,7537,7569,8271,32,152.24,4522577.48037889,6303424.81
7200,23,653700,7540,7572,8076,32,152.24,5772926.70157068,6303424.81
7201,17,1000000,7543,7572,8114,29,152.24,1614143.0049603174,6303424.81
7202,11,600000,7544,7582,8146,38,152.24,1820371.57,6303424.81
7203,11,600000,7544,7601,8146,57,152.24,1820371.57,6303424.81
7204,22,550000,7544,7563,7968,19,152.24,2904103.2512077293,6303424.81
7205,1,600000,7547,7638,8394,91,152.24,3325419.7044334975,6303424.81
7206,3,2000000,7547,7563,8606,16,152.24,9246769.549865229,6303424.81
7207,5,1500000,7548,7565,8474,17,152.24,1400922.5020242915,6303424.81
7208,22,1000000,7548,7611,8305,63,152.24,2904103.2512077293,6303424.81
7209,16,900000,7550,7575,7989,25,152.24,2465023.1840707962,6303424.81
7210,17,1200000,7550,7564,7894,14,152.24,1614143.0049603174,6303424.81
7211,1,850000,7551,7619,8461,68,152.24,3325419.7044334975,6303424.81
7212,11,800000,7551,7604,8163,53,152.24,1820371.57,6303424.81
7213,3,1000000,7554,7590,8504,36,152.24,9246769.549865229,6303424.81
7214,15,700000,7555,7593,8401,38,152.24,4522577.48037889,6303424.81
7215,5,2000000,7556,7597,8066,41,152.24,1400922.5020242915,6303424.81
7216,20,800000,7556,7628,8172,72,152.24,7597088.421768707,6303424.81
7217,17,600000,7557,7568,8367,11,152.24,1614143.0049603174,6303424.81
7218,1,800000,7557,7578,8601,21,152.24,3325419.7044334975,6303424.81
7219,12,2000000,7557,7626,8614,69,152.24,7658937.101338432,6303424.81
7220,18,1114620,7561,7828,8795,267,152.24,8584355.493548388,6303424.81
7221,1,800000,7561,7605,8669,44,152.24,3325419.7044334975,6303424.81
7222,5,3116060,7561,7737,8038,176,152.24,1400922.5020242915,6303424.81
7223,4,575000,7562,7787,8473,225,152.24,4297914.794871795,6303424.81
7224,11,1500000,7562,7600,8360,38,152.24,1820371.57,6303424.81
7225,17,750000,7563,7586,8159,23,152.24,1614143.0049603174,6303424.81
7226,16,1400000,7563,7578,8690,15,152.24,2465023.1840707962,6303424.81
7227,11,1000000,7563,7592,8898,29,152.24,1820371.57,6303424.81
7228,4,600000,7568,7620,8201,52,152.24,4297914.794871795,6303424.81
7229,4,600000,7568,7620,8108,52,152.24,4297914.794871795,6303424.81
7230,16,1000000,7570,7607,8445,37,152.24,2465023.1840707962,6303424.81
7231,11,700000,7571,7606,8766,35,152.24,1820371.57,6303424.81
7232,1,2500000,7576,7697,8194,121,152.24,3325419.7044334975,6303424.81
7233,2,900000,7576,7591,8639,15,152.24,2989003.2716499544,6303424.81
7234,16,800000,7576,7618,8432,42,152.24,2465023.1840707962,6303424.81
7235,17,700000,7578,7593,8095,15,152.24,1614143.0049603174,6303424.81
7236,15,950000,7579,7624,8913,45,152.24,4522577.48037889,6303424.81
7237,11,1800000,7579,7687,8900,108,152.24,1820371.57,6303424.81
7238,2,800000,7582,7604,8262,22,152.24,2989003.2716499544,6303424.81
7239,17,3000000,7584,7654,8643,70,152.24,1614143.0049603174,6303424.81
7240,11,1000000,7586,7612,8048,26,152.24,1820371.57,6303424.81
7241,6,760000,7586,7892,8592,306,152.24,1124713.2781954887,6303424.81
7242,13,600000,7592,8383,8814,791,152.24,7795654.71978022,6303424.81
7243,16,701221,7593,7638,7969,45,152.24,2465023.1840707962,6303424.81
7244,16,800000,7596,7638,7995,42,152.24,2465023.1840707962,6303424.81
7245,17,750000,7598,7628,8164,30,152.24,1614143.0049603174,6303424.81
7246,15,700000,7599,7656,8732,57,152.24,4522577.48037889,6303424.81
7247,17,1000000,7599,7638,8156,39,152.24,1614143.0049603174,6303424.81
7248,19,502200,7603,7646,8005,43,152.24,6721340.5708154505,6303424.81
7249,19,505200,7603,7646,8005,43,152.24,6721340.5708154505,6303424.81
7250,17,1000000,7603,7668,8867,65,152.24,1614143.0049603174,6303424.81
7251,5,600000,7604,7649,8625,45,152.24,1400922.5020242915,6303424.81
7252,16,800000,7606,7634,8209,28,152.24,2465023.1840707962,6303424.81
7253,16,800000,7607,7647,8319,40,152.24,2465023.1840707962,6303424.81
7254,17,600000,7613,7635,8384,22,152.24,1614143.0049603174,6303424.81
7255,2,791800,7617,7677,8444,60,152.24,2989003.2716499544,6303424.81
7256,3,800000,7618,7660,7837,42,152.24,9246769.549865229,6303424.81
7257,5,750000,7618,7633,7970,15,152.24,1400922.5020242915,6303424.81
7258,15,700000,7619,7633,8464,14,152.24,4522577.48037889,6303424.81
7259,11,2500000,7619,7641,8788,22,152.24,1820371.57,6303424.81
7260,2,750000,7620,7737,8727,117,152.24,2989003.2716499544,6303424.81
7261,17,700000,7620,7673,8451,53,152.24,1614143.0049603174,6303424.81
7262,8,550000,7621,7683,8234,62,152.24,1501617.2191780822,6303424.81
7263,13,700000,7625,7653,7857,28,152.24,7795654.71978022,6303424.81
7264,15,855300,7625,7681,8269,56,152.24,4522577.48037889,6303424.81
7265,15,855300,7625,7687,8269,62,152.24,4522577.48037889,6303424.81
7266,17,1600000,7626,7687,8430,61,152.24,1614143.0049603174,6303424.81
7267,19,1000000,7626,7662,8114,36,152.24,6721340.5708154505,6303424.81
7268,17,1800000,7627,7660,8433,33,152.24,1614143.0049603174,6303424.81
7269,2,700000,7627,7681,8368,54,152.24,2989003.2716499544,6303424.81
7270,17,850000,7628,7647,8151,19,152.24,1614143.0049603174,6303424.81
7271,16,800000,7629,7655,8023,26,152.24,2465023.1840707962,6303424.81
7272,1,900000,7630,7662,8639,32,152.24,3325419.7044334975,6303424.81
7273,17,800000,7632,7656,8613,24,152.24,1614143.0049603174,6303424.81
7274,17,1300000,7634,7670,8655,36,152.24,1614143.0049603174,6303424.81
7275,5,760000,7635,7668,8688,33,152.24,1400922.5020242915,6303424.81
7276,24,13500000,7635,7701,8004,66,152.24,23456062.532786883,6303424.81
7277,1,800000,7640,7674,8697,34,152.24,3325419.7044334975,6303424.81
7278,16,750000,7641,7683,8213,42,152.24,2465023.1840707962,6303424.81
7279,19,700000,7641,7701,8688,60,152.24,6721340.5708154505,6303424.81
7280,22,1058700,7642,7712,8719,70,152.24,2904103.2512077293,6303424.81
7281,22,1060800,7642,7712,8719,70,152.24,2904103.2512077293,6303424.81
7282,2,900000,7646,7669,8107,23,152.24,2989003.2716499544,6303424.81
7283,11,850000,7649,7666,8055,17,152.24,1820371.57,6303424.81
7284,5,2000000,7649,7981,8521,332,152.24,1400922.5020242915,6303424.81
7285,15,900000,7652,7666,8335,14,152.24,4522577.48037889,6303424.81
7286,16,700000,7652,7673,8004,21,152.24,2465023.1840707962,6303424.81
7287,4,700000,7652,7687,8137,35,152.24,4297914.794871795,6303424.81
7288,14,2400000,7653,7697,8884,44,152.24,5826416.914893617,6303424.81
7289,14,1200000,7654,7697,8884,43,152.24,5826416.914893617,6303424.81
7290,14,1500000,7654,7697,8887,43,152.24,5826416.914893617,6303424.81
7291,14,1200000,7654,7697,8887,43,152.24,5826416.914893617,6303424.81
7292,14,2400000,7654,7697,8887,43,152.24,5826416.914893617,6303424.81
7293,14,3000000,7654,7697,8887,43,152.24,5826416.914893617,6303424.81
7294,15,950000,7654,7670,8208,16,152.24,4522577.48037889,6303424.81
7295,12,2000000,7655,7716,8474,61,152.24,7658937.101338432,6303424.81
7296,19,700000,7656,7689,8495,33,152.24,6721340.5708154505,6303424.81
7297,12,1000000,7656,7842,8340,186,152.24,7658937.101338432,6303424.81
7298,2,850000,7659,7697,8620,38,152.24,2989003.2716499544,6303424.81
7299,5,800000,7660,7719,8748,59,152.24,1400922.5020242915,6303424.81
7300,15,550000,7661,7817,8524,156,152.24,4522577.48037889,6303424.81
7301,17,750000,7661,7682,8431,21,152.24,1614143.0049603174,6303424.81
7302,15,550000,7662,7816,8748,154,152.24,4522577.48037889,6303424.81
7303,15,550000,7662,7816,8676,154,152.24,4522577.48037889,6303424.81
7304,11,3500000,7662,7687,8921,25,152.24,1820371.57,6303424.81
7305,2,1100000,7663,7676,8436,13,152.24,2989003.2716499544,6303424.81
7306,4,800000,7663,7680,7890,17,152.24,4297914.794871795,6303424.81
7307,16,800000,7667,7687,8138,20,152.24,2465023.1840707962,6303424.81
7308,5,577000,7669,7766,7822,97,152.24,1400922.5020242915,6303424.81
7309,11,1000000,7670,7771,8166,101,152.24,1820371.57,6303424.81
7310,5,886000,7674,7691,8207,17,152.24,1400922.5020242915,6303424.81
7311,2,1000000,7675,7752,8593,77,152.24,2989003.2716499544,6303424.81
7312,2,1000000,7675,7752,8593,77,152.24,2989003.2716499544,6303424.81
7313,17,1000000,7676,7695,8789,19,152.24,1614143.0049603174,6303424.81
7314,17,1000000,7681,7870,8473,189,152.24,1614143.0049603174,6303424.81
7315,18,750000,7682,7712,8605,30,152.24,8584355.493548388,6303424.81
7316,2,600000,7688,7768,8359,80,152.24,2989003.2716499544,6303424.81
7317,17,1100000,7689,7709,8405,20,152.24,1614143.0049603174,6303424.81
7318,11,1000000,7689,7722,8662,33,152.24,1820371.57,6303424.81
7319,21,1500000,7689,7722,8052,33,152.24,17091199.984,6303424.81
7320,2,900000,7690,7726,8702,36,152.24,2989003.2716499544,6303424.81
7321,23,560000,7695,7906,8388,211,152.24,5772926.70157068,6303424.81
7322,16,900000,7695,7887,8730,192,152.24,2465023.1840707962,6303424.81
7323,17,1000000,7697,7744,8181,47,152.24,1614143.0049603174,6303424.81
7324,17,1000000,7697,7747,8831,50,152.24,1614143.0049603174,6303424.81
7325,11,800000,7702,7787,8185,85,152.24,1820371.57,6303424.81
7326,11,9000000,7703,7739,8663,36,152.24,1820371.57,6303424.81
7327,11,800000,7703,7787,8185,84,152.24,1820371.57,6303424.81
7328,16,950000,7705,7719,8010,14,152.24,2465023.1840707962,6303424.81
7329,12,800000,7709,7724,8650,15,152.24,7658937.101338432,6303424.81
7330,2,2500000,7709,7891,8731,182,152.24,2989003.2716499544,6303424.81
7331,2,1300000,7712,7779,8557,67,152.24,2989003.2716499544,6303424.81
7332,17,900000,7716,7753,8646,37,152.24,1614143.0049603174,6303424.81
7333,17,700000,7717,7795,8898,78,152.24,1614143.0049603174,6303424.81
7334,17,850000,7718,7731,8062,13,152.24,1614143.0049603174,6303424.81
7335,4,936000,7725,7733,7817,8,152.24,4297914.794871795,6303424.81
7336,1,950000,7725,7731,8208,6,152.24,3325419.7044334975,6303424.81
7337,12,900000,7726,7745,8356,19,152.24,7658937.101338432,6303424.81
7338,17,850000,7726,7774,8409,48,152.24,1614143.0049603174,6303424.81
7339,15,1700000,7729,7752,8810,23,152.24,4522577.48037889,6303424.81
7340,18,1000000,7730,7775,8669,45,152.24,8584355.493548388,6303424.81
7341,1,606000,7732,7838,8538,106,152.24,3325419.7044334975,6303424.81
7342,17,800000,7733,7750,8424,17,152.24,1614143.0049603174,6303424.81
7343,16,650000,7736,7816,8206,80,152.24,2465023.1840707962,6303424.81
7344,17,700000,7736,7801,8412,65,152.24,1614143.0049603174,6303424.81
7345,1,800000,7736,7753,8258,17,152.24,3325419.7044334975,6303424.81
7346,11,900000,7739,7778,8864,39,152.24,1820371.57,6303424.81
7347,17,600000,7743,7759,8712,16,152.24,1614143.0049603174,6303424.81
7348,12,1000000,7744,7768,8870,24,152.24,7658937.101338432,6303424.81
7349,19,900000,7746,7789,8782,43,152.24,6721340.5708154505,6303424.81
7350,2,1000000,7747,7815,8852,68,152.24,2989003.2716499544,6303424.81
7351,4,600000,7753,8212,8478,459,152.24,4297914.794871795,6303424.81
7352,19,900000,7759,7786,8426,27,152.24,6721340.5708154505,6303424.81
7353,16,1323600,7765,7807,8908,42,120.16,2465023.1840707962,3586324.4
7354,18,850000,7765,7848,8565,83,120.16,8584355.493548388,3586324.4
7355,8,800000,7767,7897,8422,130,120.16,1501617.2191780822,3586324.4
7356,17,1000000,7768,7785,8270,17,120.16,1614143.0049603174,3586324.4
7357,23,700000,7772,7918,8012,146,120.16,5772926.70157068,3586324.4
7358,17,800000,7780,7841,8443,61,120.16,1614143.0049603174,3586324.4
7359,2,1100000,7780,7823,8452,43,120.16,2989003.2716499544,3586324.4
7360,23,800000,7780,7815,8564,35,120.16,5772926.70157068,3586324.4
7361,2,650000,7782,7815,8090,33,120.16,2989003.2716499544,3586324.4
7362,17,550000,7786,7862,8377,76,120.16,1614143.0049603174,3586324.4
7363,19,1100000,7788,7837,8655,49,120.16,6721340.5708154505,3586324.4
7364,19,800000,7792,7851,8480,59,120.16,6721340.5708154505,3586324.4
7365,12,1000000,7794,7809,8459,15,120.16,7658937.101338432,3586324.4
7366,15,750000,7794,7827,8304,33,120.16,4522577.48037889,3586324.4
7367,4,5000000,7795,7845,8762,50,120.16,4297914.794871795,3586324.4
7368,2,980000,7796,7890,8765,94,120.16,2989003.2716499544,3586324.4
7369,2,900000,7802,7827,8335,25,120.16,2989003.2716499544,3586324.4
7370,15,950000,7808,7834,8303,26,120.16,4522577.48037889,3586324.4
7371,16,1000000,7810,7862,8359,52,120.16,2465023.1840707962,3586324.4
7372,15,600000,7814,7865,8527,51,120.16,4522577.48037889,3586324.4
7373,11,650000,7814,7864,8566,50,120.16,1820371.57,3586324.4
7374,15,1000000,7814,8136,8711,322,120.16,4522577.48037889,3586324.4
7375,18,750000,7816,7850,8472,34,120.16,8584355.493548388,3586324.4
7376,19,750000,7816,7941,8640,125,120.16,6721340.5708154505,3586324.4
7377,12,800000,7817,7963,8576,146,120.16,7658937.101338432,3586324.4
7378,2,2700000,7817,7848,8597,31,120.16,2989003.2716499544,3586324.4
7379,17,1000000,7819,7858,8607,39,120.16,1614143.0049603174,3586324.4
7380,12,750000,7819,8046,8380,227,120.16,7658937.101338432,3586324.4
7381,16,700000,7819,7941,8465,122,120.16,2465023.1840707962,3586324.4
7382,15,600000,7821,7859,8621,38,120.16,4522577.48037889,3586324.4
7383,12,800000,7821,7866,8354,45,120.16,7658937.101338432,3586324.4
7384,24,1500000,7822,7869,8232,47,120.16,23456062.532786883,3586324.4
7385,19,1000000,7823,7858,8457,35,120.16,6721340.5708154505,3586324.4
7386,22,800000,7827,7894,8509,67,120.16,2904103.2512077293,3586324.4
7387,13,576882,7827,7897,8493,70,120.16,7795654.71978022,3586324.4
7388,16,1000000,7827,7862,8698,35,120.16,2465023.1840707962,3586324.4
7389,11,750000,7829,7908,8782,79,120.16,1820371.57,3586324.4
7390,12,750000,7830,7845,8605,15,120.16,7658937.101338432,3586324.4
7391,1,800000,7831,7844,8272,13,120.16,3325419.7044334975,3586324.4
7392,16,1701600,7831,7890,8815,59,120.16,2465023.1840707962,3586324.4
7393,11,900000,7835,7893,8647,58,120.16,1820371.57,3586324.4
7394,12,650000,7837,7873,8360,36,120.16,7658937.101338432,3586324.4
7395,16,900000,7839,8048,8870,209,120.16,2465023.1840707962,3586324.4
7396,2,1000000,7842,7991,8880,149,120.16,2989003.2716499544,3586324.4
7397,2,750000,7843,7912,8502,69,120.16,2989003.2716499544,3586324.4
7398,11,4500000,7843,7935,8865,92,120.16,1820371.57,3586324.4
7399,15,700000,7844,7872,8537,28,120.16,4522577.48037889,3586324.4
7400,22,800000,7845,7870,8807,25,120.16,2904103.2512077293,3586324.4
7401,15,800000,7845,7872,8842,27,120.16,4522577.48037889,3586324.4
7402,5,1000000,7845,8020,8580,175,120.16,1400922.5020242915,3586324.4
7403,3,600000,7849,7989,8614,140,120.16,9246769.549865229,3586324.4
7404,11,900000,7853,7913,8573,60,120.16,1820371.57,3586324.4
7405,11,650000,7856,7876,8163,20,120.16,1820371.57,3586324.4
7406,23,900000,7860,7947,8231,87,120.16,5772926.70157068,3586324.4
7407,1,700000,7862,7884,8466,22,120.16,3325419.7044334975,3586324.4
7408,17,1000000,7862,7920,8669,58,120.16,1614143.0049603174,3586324.4
7409,12,700000,7863,7939,8524,76,120.16,7658937.101338432,3586324.4
7410,5,635000,7863,7906,8573,43,120.16,1400922.5020242915,3586324.4
7411,1,850000,7866,7907,8684,41,120.16,3325419.7044334975,3586324.4
7412,22,600000,7868,7932,8464,64,120.16,2904103.2512077293,3586324.4
7413,0,900000,7869,7898,8114,29,120.16,8418173.322222222,3586324.4
7414,18,1000000,7869,7897,8578,28,120.16,8584355.493548388,3586324.4
7415,4,800000,7871,7885,8352,14,120.16,4297914.794871795,3586324.4
7416,2,650000,7872,7887,8383,15,120.16,2989003.2716499544,3586324.4
7417,24,1800000,7872,7907,8391,35,120.16,23456062.532786883,3586324.4
7418,10,1176000,7872,7953,8716,81,120.16,8282326.220930233,3586324.4
7419,1,950000,7873,7906,8495,33,120.16,3325419.7044334975,3586324.4
7420,7,1000000,7874,7919,8429,45,120.16,3738553.685483871,3586324.4
7421,10,650000,7875,7957,8401,82,120.16,8282326.220930233,3586324.4
7422,18,1000000,7876,7914,8746,38,120.16,8584355.493548388,3586324.4
7423,15,1100000,7878,7990,8494,112,120.16,4522577.48037889,3586324.4
7424,16,1500000,7878,7927,8843,49,120.16,2465023.1840707962,3586324.4
7425,15,645000,7879,8132,8663,253,120.16,4522577.48037889,3586324.4
7426,11,900000,7881,7901,8706,20,120.16,1820371.57,3586324.4
7427,11,900000,7881,7955,8437,74,120.16,1820371.57,3586324.4
7428,15,1000000,7882,7935,8291,53,120.16,4522577.48037889,3586324.4
7429,15,600000,7884,7948,8773,64,120.16,4522577.48037889,3586324.4
7430,3,670000,7884,7892,8453,8,120.16,9246769.549865229,3586324.4
7431,15,600000,7885,7968,8814,83,120.16,4522577.48037889,3586324.4
7432,15,600000,7885,8017,8814,132,120.16,4522577.48037889,3586324.4
7433,2,900000,7889,7954,8528,65,120.16,2989003.2716499544,3586324.4
7434,2,800000,7889,8221,8788,332,120.16,2989003.2716499544,3586324.4
7435,17,1000000,7890,7970,8677,80,120.16,1614143.0049603174,3586324.4
7436,13,2000000,7891,7900,8080,9,120.16,7795654.71978022,3586324.4
7437,15,700000,7891,7912,8394,21,120.16,4522577.48037889,3586324.4
7438,2,900000,7891,7907,8249,16,120.16,2989003.2716499544,3586324.4
7439,12,3000000,7891,7985,8790,94,120.16,7658937.101338432,3586324.4
7440,1,1000000,7892,7947,8601,55,120.16,3325419.7044334975,3586324.4
7441,16,650000,7894,7912,8576,18,120.16,2465023.1840707962,3586324.4
7442,17,900000,7894,7918,8412,24,120.16,1614143.0049603174,3586324.4
7443,3,3700000,7894,7925,8213,31,120.16,9246769.549865229,3586324.4
7444,11,1800000,7894,8003,8863,109,120.16,1820371.57,3586324.4
7445,2,700000,7896,7976,8443,80,120.16,2989003.2716499544,3586324.4
7446,17,600000,7897,7906,8349,9,120.16,1614143.0049603174,3586324.4
7447,11,950000,7900,7920,8639,20,120.16,1820371.57,3586324.4
7448,24,1800000,7901,7934,8236,33,120.16,23456062.532786883,3586324.4
7449,6,700000,7901,7970,8278,69,120.16,1124713.2781954887,3586324.4
7450,17,600000,7902,7953,8499,51,120.16,1614143.0049603174,3586324.4
7451,18,900000,7903,7941,8789,38,120.16,8584355.493548388,3586324.4
7452,15,560000,7905,7936,8388,31,120.16,4522577.48037889,3586324.4
7453,15,800000,7908,7935,8521,27,120.16,4522577.48037889,3586324.4
7454,2,750000,7908,7932,8410,24,120.16,2989003.2716499544,3586324.4
7455,2,900000,7913,7976,8825,63,120.16,2989003.2716499544,3586324.4
7456,2,1924520,7915,7978,8801,63,120.16,2989003.2716499544,3586324.4
7457,5,600000,7916,8017,8459,101,120.16,1400922.5020242915,3586324.4
7458,2,700000,7917,7936,8422,19,120.16,2989003.2716499544,3586324.4
7459,17,850000,7918,7960,8478,42,120.16,1614143.0049603174,3586324.4
7460,17,700000,7921,8020,8584,99,120.16,1614143.0049603174,3586324.4
7461,17,600000,7921,8012,8635,91,120.16,1614143.0049603174,3586324.4
7462,5,650000,7921,7956,8321,35,120.16,1400922.5020242915,3586324.4
7463,12,1000000,7922,7964,8454,42,120.16,7658937.101338432,3586324.4
7464,16,1000000,7923,7954,8411,31,120.16,2465023.1840707962,3586324.4
7465,17,1000000,7923,7950,8397,27,120.16,1614143.0049603174,3586324.4
7466,17,600000,7926,7954,8514,28,120.16,1614143.0049603174,3586324.4
7467,5,2099200,7928,7954,8654,26,120.16,1400922.5020242915,3586324.4
7468,22,600000,7928,7997,8678,69,120.16,2904103.2512077293,3586324.4
7469,3,700000,7929,7962,8319,33,120.16,9246769.549865229,3586324.4
7470,14,600000,7932,8191,8447,259,120.16,5826416.914893617,3586324.4
7471,17,960000,7935,7950,8723,15,120.16,1614143.0049603174,3586324.4
7472,1,550000,7935,7955,8291,20,120.16,3325419.7044334975,3586324.4
7473,2,700000,7936,7981,8446,45,120.16,2989003.2716499544,3586324.4
7474,5,900000,7936,7957,8320,21,120.16,1400922.5020242915,3586324.4
7475,16,1800000,7940,8006,8678,66,120.16,2465023.1840707962,3586324.4
7476,16,1826000,7940,7962,8499,22,120.16,2465023.1840707962,3586324.4
7477,18,1500000,7941,8016,8694,75,120.16,8584355.493548388,3586324.4
7478,1,800000,7945,7960,8817,15,120.16,3325419.7044334975,3586324.4
7479,15,650000,7945,8034,8403,89,120.16,4522577.48037889,3586324.4
7480,17,800000,7946,8003,8774,57,120.16,1614143.0049603174,3586324.4
7481,2,2000000,7947,8003,8880,56,120.16,2989003.2716499544,3586324.4
7482,12,950000,7947,7977,8500,30,120.16,7658937.101338432,3586324.4
7483,15,600000,7949,8020,8797,71,120.16,4522577.48037889,3586324.4
7484,1,600000,7950,7971,8804,21,120.16,3325419.7044334975,3586324.4
7485,1,600000,7953,7976,8712,23,120.16,3325419.7044334975,3586324.4
7486,11,1500000,7953,7988,8712,35,120.16,1820371.57,3586324.4
7487,24,800000,7954,8221,8361,267,120.16,23456062.532786883,3586324.4
7488,11,1500000,7955,7969,8865,14,120.16,1820371.57,3586324.4
7489,8,1000000,7955,8102,8747,147,120.16,1501617.2191780822,3586324.4
7490,11,1200000,7956,8018,8688,62,120.16,1820371.57,3586324.4
7491,11,800000,7957,8096,8831,139,120.16,1820371.57,3586324.4
7492,5,750000,7959,7997,8257,38,120.16,1400922.5020242915,3586324.4
7493,5,900000,7961,7989,8844,28,120.16,1400922.5020242915,3586324.4
7494,12,800000,7961,8010,8478,49,120.16,7658937.101338432,3586324.4
7495,16,700000,7962,8016,8545,54,120.16,2465023.1840707962,3586324.4
7496,17,1569200,7966,7989,8682,23,120.16,1614143.0049603174,3586324.4
7497,20,600000,7967,7995,8891,28,120.16,7597088.421768707,3586324.4
7498,17,600000,7967,8033,8279,66,120.16,1614143.0049603174,3586324.4
7499,5,600000,7969,7995,8678,26,120.16,1400922.5020242915,3586324.4
7500,16,1793200,7970,8017,8753,47,120.16,2465023.1840707962,3586324.4
7501,17,600000,7972,7999,8816,27,120.16,1614143.0049603174,3586324.4
7502,17,1000000,7975,8054,8901,79,120.16,1614143.0049603174,3586324.4
7503,1,1000000,7976,7991,8734,15,120.16,3325419.7044334975,3586324.4
7504,2,600000,7976,8018,8706,42,120.16,2989003.2716499544,3586324.4
7505,2,900000,7977,8013,8650,36,120.16,2989003.2716499544,3586324.4
7506,6,800000,7977,8023,8762,46,120.16,1124713.2781954887,3586324.4
7507,16,800000,7979,8012,8522,33,120.16,2465023.1840707962,3586324.4
7508,2,700000,7981,8003,8479,22,120.16,2989003.2716499544,3586324.4
7509,2,800000,7981,8006,8650,25,120.16,2989003.2716499544,3586324.4
7510,19,800000,7982,8144,8367,162,120.16,6721340.5708154505,3586324.4
7511,12,1000000,7983,7997,8710,14,120.16,7658937.101338432,3586324.4
7512,2,900000,7983,8011,8482,28,120.16,2989003.2716499544,3586324.4
7513,0,25000000,7983,8047,8782,64,120.16,8418173.322222222,3586324.4
7514,17,1000000,7988,8006,8786,18,120.16,1614143.0049603174,3586324.4
7515,12,750000,7989,8088,8919,99,120.16,7658937.101338432,3586324.4
7516,12,950000,7989,8018,8506,29,120.16,7658937.101338432,3586324.4
7517,15,800000,7990,8025,8675,35,120.16,4522577.48037889,3586324.4
7518,11,1200000,7995,8031,8636,36,120.16,1820371.57,3586324.4
7519,17,800000,7996,8062,8695,66,120.16,1614143.0049603174,3586324.4
7520,11,800000,7998,8027,8697,29,120.16,1820371.57,3586324.4
7521,24,750000,7999,8039,8790,40,120.16,23456062.532786883,3586324.4
7522,10,700000,8002,8052,8542,50,120.16,8282326.220930233,3586324.4
7523,11,1000000,8003,8026,8529,23,120.16,1820371.57,3586324.4
7524,2,800000,8003,8025,8774,22,120.16,2989003.2716499544,3586324.4
7525,2,950000,8004,8026,8629,22,120.16,2989003.2716499544,3586324.4
7526,11,1000000,8005,8027,8786,22,120.16,1820371.57,3586324.4
7527,1,1250000,8006,8060,8530,54,120.16,3325419.7044334975,3586324.4
7528,15,515000,8008,8074,8558,66,120.16,4522577.48037889,3586324.4
7529,17,600000,8008,8222,8877,214,120.16,1614143.0049603174,3586324.4
7530,17,600000,8008,8222,8877,214,120.16,1614143.0049603174,3586324.4
7531,9,700000,8010,8040,8424,30,120.16,3707403.8834951455,3586324.4
7532,12,900000,8011,8039,8835,28,120.16,7658937.101338432,3586324.4
7533,17,700000,8016,8033,8796,17,120.16,1614143.0049603174,3586324.4
7534,15,650000,8017,8055,8634,38,120.16,4522577.48037889,3586324.4
7535,15,650000,8017,8058,8634,41,120.16,4522577.48037889,3586324.4
7536,3,1200000,8018,8055,8447,37,120.16,9246769.549865229,3586324.4
7537,13,1000000,8027,8072,8725,45,120.16,7795654.71978022,3586324.4
7538,15,800000,8029,8144,8888,115,120.16,4522577.48037889,3586324.4
7539,13,750000,8032,8081,8824,49,120.16,7795654.71978022,3586324.4
7540,14,1000000,8033,8110,8901,77,120.16,5826416.914893617,3586324.4
7541,16,800000,8036,8068,8738,32,120.16,2465023.1840707962,3586324.4
7542,15,1498800,8038,8055,8907,17,120.16,4522577.48037889,3586324.4
7543,17,900000,8040,8088,8601,48,120.16,1614143.0049603174,3586324.4
7544,5,1000000,8047,8069,8530,22,120.16,1400922.5020242915,3586324.4
7545,22,940000,8053,8094,8726,41,120.16,2904103.2512077293,3586324.4
7546,2,600000,8060,8115,8712,55,120.16,2989003.2716499544,3586324.4
7547,17,1000000,8061,8102,8731,41,120.16,1614143.0049603174,3586324.4
7548,11,850000,8061,8117,8893,56,120.16,1820371.57,3586324.4
7549,24,8000000,8061,8212,8781,151,120.16,23456062.532786883,3586324.4
7550,5,700000,8062,8096,8502,34,120.16,1400922.5020242915,3586324.4
7551,5,700000,8062,8135,8629,73,120.16,1400922.5020242915,3586324.4
7552,18,772282,8066,8104,8822,38,120.16,8584355.493548388,3586324.4
7553,2,600000,8066,8129,8921,63,120.16,2989003.2716499544,3586324.4
7554,19,1200000,8068,8097,8754,29,120.16,6721340.5708154505,3586324.4
7555,23,750000,8072,8108,8751,36,120.16,5772926.70157068,3586324.4
7556,15,1000000,8073,8130,8527,57,120.16,4522577.48037889,3586324.4
7557,9,4500000,8074,8129,8559,55,120.16,3707403.8834951455,3586324.4
7558,15,1000000,8078,8142,8530,64,120.16,4522577.48037889,3586324.4
7559,16,1000000,8082,8104,8894,22,120.16,2465023.1840707962,3586324.4
7560,17,600000,8083,8125,8321,42,120.16,1614143.0049603174,3586324.4
7561,6,1000000,8087,8165,8766,78,120.16,1124713.2781954887,3586324.4
7562,3,5000000,8087,8132,8585,45,120.16,9246769.549865229,3586324.4
7563,24,26500000,8088,8124,8397,36,120.16,23456062.532786883,3586324.4
7564,12,1300000,8090,8109,8782,19,120.16,7658937.101338432,3586324.4
7565,2,800000,8090,8107,8872,17,120.16,2989003.2716499544,3586324.4
7566,12,1000000,8092,8110,8908,18,120.16,7658937.101338432,3586324.4
7567,15,1000000,8093,8156,8669,63,120.16,4522577.48037889,3586324.4
7568,17,1000000,8093,8152,8899,59,120.16,1614143.0049603174,3586324.4
7569,2,900000,8095,8137,8886,42,120.16,2989003.2716499544,3586324.4
7570,13,2000000,8096,8167,8824,71,120.16,7795654.71978022,3586324.4
7571,11,700000,8102,8159,8874,57,120.16,1820371.57,3586324.4
7572,11,700000,8102,8142,8738,40,120.16,1820371.57,3586324.4
7573,12,1000000,8103,8170,8754,67,120.16,7658937.101338432,3586324.4
7574,17,1000000,8104,8191,8801,87,120.16,1614143.0049603174,3586324.4
7575,2,900000,8105,8193,8739,88,120.16,2989003.2716499544,3586324.4
7576,15,1000000,8107,8144,8858,37,120.16,4522577.48037889,3586324.4
7577,17,1000000,8108,8220,8803,112,120.16,1614143.0049603174,3586324.4
7578,4,1500000,8109,8334,8902,225,120.16,4297914.794871795,3586324.4
7579,3,5000000,8110,8164,8367,54,120.16,9246769.549865229,3586324.4
7580,3,1000000,8112,8157,8765,45,120.16,9246769.549865229,3586324.4
7581,17,1500000,8114,8200,8697,86,120.16,1614143.0049603174,3586324.4
7582,11,800000,8114,8201,8872,87,120.16,1820371.57,3586324.4
7583,9,700000,8115,8156,8634,41,120.16,3707403.8834951455,3586324.4
7584,23,700000,8117,8129,8732,12,120.16,5772926.70157068,3586324.4
7585,12,1000000,8122,8194,8894,72,120.16,7658937.101338432,3586324.4
7586,15,750000,8123,8179,8730,56,120.16,4522577.48037889,3586324.4
7587,21,3000000,8127,8156,8524,29,99.44,17091199.984,1975331.43
7588,19,1200000,8130,8158,8759,28,99.44,6721340.5708154505,1975331.43
7589,17,1250000,8132,8198,8668,66,99.44,1614143.0049603174,1975331.43
7590,2,900000,8140,8179,8649,39,99.44,2989003.2716499544,1975331.43
7591,12,1000000,8142,8181,8782,39,99.44,7658937.101338432,1975331.43
7592,15,700000,8142,8269,8649,127,99.44,4522577.48037889,1975331.43
7593,15,700000,8142,8257,8649,115,99.44,4522577.48037889,1975331.43
7594,2,800000,8142,8165,8797,23,99.44,2989003.2716499544,1975331.43
7595,17,1000000,8143,8205,8611,62,99.44,1614143.0049603174,1975331.43
7596,15,750000,8144,8166,8478,22,99.44,4522577.48037889,1975331.43
7597,15,900000,8144,8202,8886,58,99.44,4522577.48037889,1975331.43
7598,11,850000,8146,8215,8879,69,99.44,1820371.57,1975331.43
7599,11,502000,8146,8222,8829,76,99.44,1820371.57,1975331.43
7600,2,850000,8149,8201,8824,52,99.44,2989003.2716499544,1975331.43
7601,24,700000,8151,8180,8410,29,99.44,23456062.532786883,1975331.43
7602,5,1000000,8153,8187,8738,34,99.44,1400922.5020242915,1975331.43
7603,5,1000000,8153,8187,8641,34,99.44,1400922.5020242915,1975331.43
7604,3,3000000,8153,8171,8884,18,99.44,9246769.549865229,1975331.43
7605,17,750000,8159,8186,8760,27,99.44,1614143.0049603174,1975331.43
7606,17,1000000,8160,8219,8816,59,99.44,1614143.0049603174,1975331.43
7607,21,2900000,8160,8213,8437,53,99.44,17091199.984,1975331.43
7608,0,2000000,8163,8221,8453,58,99.44,8418173.322222222,1975331.43
7609,16,600000,8164,8236,8689,72,99.44,2465023.1840707962,1975331.43
7610,15,800000,8164,8193,8646,29,99.44,4522577.48037889,1975331.43
7611,17,800000,8164,8213,8716,49,99.44,1614143.0049603174,1975331.43
7612,17,800000,8164,8209,8690,45,99.44,1614143.0049603174,1975331.43
7613,9,900000,8165,8185,8747,20,99.44,3707403.8834951455,1975331.43
7614,17,800000,8165,8255,8734,90,99.44,1614143.0049603174,1975331.43
7615,2,1200000,8166,8221,8828,55,99.44,2989003.2716499544,1975331.43
7616,5,830000,8170,8306,8797,136,99.44,1400922.5020242915,1975331.43
7617,4,900000,8171,8206,8915,35,99.44,4297914.794871795,1975331.43
7618,1,955640,8172,8263,8695,91,99.44,3325419.7044334975,1975331.43
7619,4,1000000,8173,8223,8795,50,99.44,4297914.794871795,1975331.43
7620,15,900000,8181,8202,8803,21,99.44,4522577.48037889,1975331.43
7621,15,650000,8186,8244,8769,58,99.44,4522577.48037889,1975331.43
7622,23,850000,8188,8256,8825,68,99.44,5772926.70157068,1975331.43
7623,2,1200000,8191,8209,8788,18,99.44,2989003.2716499544,1975331.43
7624,5,1000000,8191,8219,8647,28,99.44,1400922.5020242915,1975331.43
7625,16,1000000,8192,8244,8814,52,99.44,2465023.1840707962,1975331.43
7626,2,900000,8193,8223,8885,30,99.44,2989003.2716499544,1975331.43
7627,17,1300000,8194,8213,8688,19,99.44,1614143.0049603174,1975331.43
7628,24,10000000,8198,8300,8775,102,99.44,23456062.532786883,1975331.43
7629,5,1100000,8198,8214,8656,16,99.44,1400922.5020242915,1975331.43
7630,24,1460000,8201,8258,8482,57,99.44,23456062.532786883,1975331.43
7631,18,600000,8206,8243,8907,37,99.44,8584355.493548388,1975331.43
7632,6,700000,8209,8324,8769,115,99.44,1124713.2781954887,1975331.43
7633,1,800000,8210,8234,8845,24,99.44,3325419.7044334975,1975331.43
7634,2,800000,8213,8576,8907,363,99.44,2989003.2716499544,1975331.43
7635,12,800000,8219,8319,8796,100,99.44,7658937.101338432,1975331.43
7636,2,600000,8222,8300,8790,78,99.44,2989003.2716499544,1975331.43
7637,5,540000,8222,8353,8839,131,99.44,1400922.5020242915,1975331.43
7638,5,650000,8223,8257,8621,34,99.44,1400922.5020242915,1975331.43
7639,15,1000000,8228,8270,8835,42,99.44,4522577.48037889,1975331.43
7640,15,1000000,8228,8286,8808,58,99.44,4522577.48037889,1975331.43
7641,13,800000,8234,8250,8677,16,99.44,7795654.71978022,1975331.43
7642,5,600000,8236,8387,8767,151,99.44,1400922.5020242915,1975331.43
7643,17,1000000,8240,8272,8922,32,99.44,1614143.0049603174,1975331.43
7644,17,900000,8242,8313,8809,71,99.44,1614143.0049603174,1975331.43
7645,2,1000000,8250,8310,8769,60,99.44,2989003.2716499544,1975331.43
7646,17,750000,8250,8277,8472,27,99.44,1614143.0049603174,1975331.43
7647,1,700000,8254,8276,8720,22,99.44,3325419.7044334975,1975331.43
7648,15,800000,8254,8368,8913,114,99.44,4522577.48037889,1975331.43
7649,2,735000,8262,8271,8447,9,99.44,2989003.2716499544,1975331.43
7650,12,1200000,8269,8271,8667,2,99.44,7658937.101338432,1975331.43
7651,11,1000000,8270,8291,8814,21,99.44,1820371.57,1975331.43
7652,3,14134300,8276,8395,8829,119,99.44,9246769.549865229,1975331.43
7653,4,1500000,8277,8654,8864,377,99.44,4297914.794871795,1975331.43
7654,4,1500000,8277,8471,8865,194,99.44,4297914.794871795,1975331.43
7655,2,600000,8278,8311,8893,33,99.44,2989003.2716499544,1975331.43
7656,2,1000000,8285,8331,8724,46,99.44,2989003.2716499544,1975331.43
7657,24,2500000,8290,8312,8536,22,99.44,23456062.532786883,1975331.43
7658,16,750000,8290,8345,8699,55,99.44,2465023.1840707962,1975331.43
7659,24,1235000,8292,8382,8424,90,99.44,23456062.532786883,1975331.43
7660,17,600000,8298,8352,8657,54,99.44,1614143.0049603174,1975331.43
7661,21,8000000,8298,8319,8597,21,99.44,17091199.984,1975331.43
7662,17,1000000,8299,8383,8824,84,99.44,1614143.0049603174,1975331.43
7663,5,650000,8300,8368,8398,68,99.44,1400922.5020242915,1975331.43
7664,13,650000,8301,8340,8641,39,99.44,7795654.71978022,1975331.43
7665,11,1000000,8306,8327,8859,21,99.44,1820371.57,1975331.43
7666,4,1200000,8312,8341,8670,29,99.44,4297914.794871795,1975331.43
7667,15,700000,8314,8376,8846,62,99.44,4522577.48037889,1975331.43
7668,24,2500000,8319,8342,8745,23,99.44,23456062.532786883,1975331.43
7669,19,900000,8321,8376,8774,55,99.44,6721340.5708154505,1975331.43
7670,24,2000000,8321,8356,8780,35,99.44,23456062.532786883,1975331.43
7671,17,2120000,8324,8389,8815,65,99.44,1614143.0049603174,1975331.43
7672,4,750000,8329,8346,8846,17,99.44,4297914.794871795,1975331.43
7673,2,1500000,8341,8356,8795,15,99.44,2989003.2716499544,1975331.43
7674,9,750000,8343,8366,8836,23,99.44,3707403.8834951455,1975331.43
7675,22,525000,8346,8422,8865,76,99.44,2904103.2512077293,1975331.43
7676,11,700000,8352,8487,8801,135,99.44,1820371.57,1975331.43
7677,24,785000,8355,8394,8548,39,99.44,23456062.532786883,1975331.43
7678,14,5500000,8355,8418,8744,63,99.44,5826416.914893617,1975331.43
7679,2,700000,8362,8391,8852,29,99.44,2989003.2716499544,1975331.43
7680,17,1500000,8368,8412,8752,44,99.44,1614143.0049603174,1975331.43
7681,9,1000000,8380,8394,8482,14,99.44,3707403.8834951455,1975331.43
7682,21,600000,8403,8423,8766,20,99.44,17091199.984,1975331.43
7683,24,1091220,8416,8446,8793,30,99.44,23456062.532786883,1975331.43
7684,17,1000000,8417,8445,8808,28,99.44,1614143.0049603174,1975331.43
7685,23,600000,8423,8432,8788,9,99.44,5772926.70157068,1975331.43
7686,3,1000000,8425,8459,8795,34,99.44,9246769.549865229,1975331.43
7687,21,800000,8457,8475,8879,18,99.44,17091199.984,1975331.43
7688,13,600000,8471,8503,8769,32,99.44,7795654.71978022,1975331.43
7689,18,900000,8488,8503,8866,15,99.44,8584355.493548388,1975331.43
7690,19,700000,8508,8565,8859,57,65.64,6721340.5708154505,1503028.14
7691,3,4700000,8514,8543,8779,29,65.64,9246769.549865229,1503028.14
7692,24,2500000,8531,8597,8773,66,65.64,23456062.532786883,1503028.14
7693,24,1800000,8542,8562,8747,20,65.64,23456062.532786883,1503028.14
7694,2,900000,8555,8580,8844,25,65.64,2989003.2716499544,1503028.14
7695,4,2000000,8556,8577,8597,21,65.64,4297914.794871795,1503028.14
7696,24,3000000,8576,8607,8901,31,65.64,23456062.532786883,1503028.14
7697,17,800000,8633,8650,8774,17,65.64,1614143.0049603174,1503028.14
7698,23,1000000,8639,8690,8884,51,65.64,5772926.70157068,1503028.14
7699,24,2000000,8649,8692,8915,43,65.64,23456062.532786883,1503028.14
7700,24,1800000,8661,8689,8865,28,65.64,23456062.532786883,1503028.14
7701,3,559333,8669,8690,8922,21,65.64,9246769.549865229,1503028.14
7702,19,1000000,8726,8730,8907,4,65.64,6721340.5708154505,1503028.14
7703,22,3000000,18,60,7436,42,179.4,2904103.2512077293,8579311.0
7704,17,1500000,4874,4890,6270,16,253.83,1614143.0049603174,6984378.81
7705,3,150000,4875,4881,6028,6,253.83,9246769.549865229,6984378.81
7706,5,1000000,5519,5561,6111,42,246.12,1400922.5020242915,6701891.81
7707,23,385000,5542,5555,6206,13,246.12,5772926.70157068,6701891.81
7708,24,500000,5650,5658,6135,8,104.75,23456062.532786883,3369660.19
7709,24,60000,5689,5700,6102,11,104.75,23456062.532786883,3369660.19
7710,12,292486,5734,5763,5967,29,104.75,7658937.101338432,3369660.19
7711,5,266750,5763,5804,6045,41,104.75,1400922.5020242915,3369660.19
7712,24,1013323,5862,5885,6064,23,104.75,23456062.532786883,3369660.19
7713,24,700000,598,800,,202,202.94,23456062.532786883,7117555.88
7714,24,15000,626,670,,44,202.94,23456062.532786883,7117555.88
7715,4,2000000,635,1165,,530,202.94,4297914.794871795,7117555.88
7716,24,1800000,655,800,,145,202.94,23456062.532786883,7117555.88
7717,12,75000,661,677,,16,202.94,7658937.101338432,7117555.88
7718,12,200000,661,669,,8,202.94,7658937.101338432,7117555.88
7719,15,50000,785,792,,7,202.94,4522577.48037889,7117555.88
7720,11,5000000,863,927,,64,140.14,1820371.57,7336579.66
7721,12,100000,1024,1027,,3,140.14,7658937.101338432,7336579.66
7722,23,25000,1271,1346,,75,219.0,5772926.70157068,7652071.6
7723,12,900000,1348,1356,,8,219.0,7658937.101338432,7652071.6
7724,24,400000,1620,1677,,57,423.81,23456062.532786883,11229609.36
7725,12,250000,1642,1697,,55,423.81,7658937.101338432,11229609.36
7726,24,1000000,1713,1741,,28,423.81,23456062.532786883,11229609.36
7727,17,192755,1745,1745,,0,423.81,1614143.0049603174,11229609.36
7728,12,35000,1768,1774,,6,423.81,7658937.101338432,11229609.36
7729,11,70000,1788,2026,,238,423.81,1820371.57,11229609.36
7730,3,30000,1832,1888,,56,423.81,9246769.549865229,11229609.36
7731,23,60000,1832,1879,,47,423.81,5772926.70157068,11229609.36
7732,24,1500000,1858,1893,,35,423.81,23456062.532786883,11229609.36
7733,12,900000,1993,2006,,13,166.1,7658937.101338432,3498084.51
7734,3,240000,1998,2017,,19,166.1,9246769.549865229,3498084.51
7735,12,500000,2006,2006,,0,166.1,7658937.101338432,3498084.51
7736,12,4000000,2031,2105,,74,166.1,7658937.101338432,3498084.51
7737,4,40000,2062,2087,,25,166.1,4297914.794871795,3498084.51
7738,15,30000,2083,2633,,550,166.1,4522577.48037889,3498084.51
7739,23,500000,2146,2153,,7,166.1,5772926.70157068,3498084.51
7740,24,50000,2151,2188,,37,166.1,23456062.532786883,3498084.51
7741,24,500000,2228,2314,,86,166.1,23456062.532786883,3498084.51
7742,2,50000,2227,2250,,23,166.1,2989003.2716499544,3498084.51
7743,11,1700000,2272,2507,,235,166.1,1820371.57,3498084.51
7744,24,200000,2328,2342,,14,230.03,23456062.532786883,14812242.86
7745,15,18000,2374,2391,,17,230.03,4522577.48037889,14812242.86
7746,15,31000,2374,2403,,29,230.03,4522577.48037889,14812242.86
7747,15,35000,2411,2417,,6,230.03,4522577.48037889,14812242.86
7748,3,50000,2416,2584,,168,230.03,9246769.549865229,14812242.86
7749,5,7000,2560,2591,,31,230.03,1400922.5020242915,14812242.86
7750,3,5000,2662,2665,,3,417.96,9246769.549865229,14954908.92
7751,2,3400000,2690,2755,,65,417.96,2989003.2716499544,14954908.92
7752,1,200000,2733,2755,,22,417.96,3325419.7044334975,14954908.92
7753,3,60000,3046,3068,,22,281.46,9246769.549865229,11503993.02
7754,1,360000,3152,3180,,28,281.46,3325419.7044334975,11503993.02
7755,5,100000,3244,3405,,161,281.46,1400922.5020242915,11503993.02
7756,1,400000,3448,3897,,449,205.39,3325419.7044334975,9006193.27
7757,17,90000,3461,3622,,161,205.39,1614143.0049603174,9006193.27
7758,3,100000,3608,3623,,15,205.39,9246769.549865229,9006193.27
7759,2,25000,3642,3650,,8,205.39,2989003.2716499544,9006193.27
7760,24,50000,3734,3796,,62,205.39,23456062.532786883,9006193.27
7761,24,250000,3734,3841,,107,205.39,23456062.532786883,9006193.27
7762,24,1000,3844,3943,,99,312.72,23456062.532786883,13350024.59
7763,24,100000,3888,3943,,55,312.72,23456062.532786883,13350024.59
7764,24,100000,3894,3974,,80,312.72,23456062.532786883,13350024.59
7765,24,50000000,3935,4072,,137,312.72,23456062.532786883,13350024.59
7766,24,50000,3938,3946,,8,312.72,23456062.532786883,13350024.59
7767,24,15000,6092,6168,,76,141.64,23456062.532786883,5089136.37
7768,24,1000000,4069,4210,,141,312.72,23456062.532786883,13350024.59
7769,3,291000,4134,4145,,11,248.15,9246769.549865229,12693718.64
7770,5,200000,4273,4373,,100,248.15,1400922.5020242915,12693718.64
7771,17,2200000,4281,4408,,127,248.15,1614143.0049603174,12693718.64
7772,9,60000,4414,4428,,14,248.15,3707403.8834951455,12693718.64
7773,24,250000,4455,4483,,28,248.15,23456062.532786883,12693718.64
7774,2,40000,4457,4496,,39,248.15,2989003.2716499544,12693718.64
7775,24,120000,4504,4510,,6,258.28,23456062.532786883,7314077.5
7776,24,6000000,4623,4709,,86,258.28,23456062.532786883,7314077.5
7777,3,650000,4919,4939,,20,253.83,9246769.549865229,6984378.81
7778,2,330000,5049,5062,,13,253.83,2989003.2716499544,6984378.81
7779,24,250000,5128,5148,,20,253.83,23456062.532786883,6984378.81
7780,3,350000,5129,5143,,14,253.83,9246769.549865229,6984378.81
7781,4,420000,5139,5142,,3,253.83,4297914.794871795,6984378.81
7782,15,75000,5146,5162,,16,253.83,4522577.48037889,6984378.81
7783,20,5000000,5183,5412,,229,253.83,7597088.421768707,6984378.81
7784,2,830000,5246,5255,,9,246.12,2989003.2716499544,6701891.81
7785,18,600000,5246,5260,,14,246.12,8584355.493548388,6701891.81
7786,18,500000,5246,5260,,14,246.12,8584355.493548388,6701891.81
7787,18,220000,5246,5258,,12,246.12,8584355.493548388,6701891.81
7788,18,270000,5246,5260,,14,246.12,8584355.493548388,6701891.81
7789,5,75000,5531,5862,,331,246.12,1400922.5020242915,6701891.81
7790,12,250000,5680,5707,,27,104.75,7658937.101338432,3369660.19
7791,7,700000,5687,5770,,83,104.75,3738553.685483871,3369660.19
7792,7,4350000,5695,5738,,43,104.75,3738553.685483871,3369660.19
7793,13,550000,5899,5926,,27,104.75,7795654.71978022,3369660.19
7794,12,7000000,5925,5952,,27,104.75,7658937.101338432,3369660.19
7795,24,50000,5953,5965,,12,141.64,23456062.532786883,5089136.37
7796,24,101000,6009,6039,,30,141.64,23456062.532786883,5089136.37
7797,1,290000,6058,6088,,30,141.64,3325419.7044334975,5089136.37
7798,23,9000000,6073,6093,,20,141.64,5772926.70157068,5089136.37
7799,12,28000000,6081,6140,,59,141.64,7658937.101338432,5089136.37
7800,12,9120000,6126,6155,,29,141.64,7658937.101338432,5089136.37
7801,3,142300,6177,6233,,56,141.64,9246769.549865229,5089136.37
7802,15,6407100,6325,6359,,34,170.53,4522577.48037889,5237438.95
7803,18,3300000,6329,6345,,16,170.53,8584355.493548388,5237438.95
7804,1,450000,6340,6427,,87,170.53,3325419.7044334975,5237438.95
7805,21,400000,6367,6410,,43,170.53,17091199.984,5237438.95
7806,1,4400000,6373,6429,,56,170.53,3325419.7044334975,5237438.95
7807,7,240000,6399,6437,,38,170.53,3738553.685483871,5237438.95
7808,21,1900000,6410,6428,,18,170.53,17091199.984,5237438.95
7809,7,480000,6413,6445,,32,170.53,3738553.685483871,5237438.95
7810,5,100000,6432,6455,,23,170.53,1400922.5020242915,5237438.95
7811,2,1140000,6452,6556,,104,170.53,2989003.2716499544,5237438.95
7812,5,50000,6452,6599,,147,170.53,1400922.5020242915,5237438.95
7813,3,210000,6473,6511,,38,170.53,9246769.549865229,5237438.95
7814,12,61000000,6504,6549,,45,170.53,7658937.101338432,5237438.95
7815,12,61000000,6542,7313,,771,170.53,7658937.101338432,5237438.95
7816,24,25000,6571,6618,,47,170.53,23456062.532786883,5237438.95
7817,17,12000000,6619,6675,,56,170.53,1614143.0049603174,5237438.95
7818,3,1000000,6619,6646,,27,170.53,9246769.549865229,5237438.95
7819,3,80000,6638,6655,,17,170.53,9246769.549865229,5237438.95
7820,1,550000,6641,6717,,76,170.53,3325419.7044334975,5237438.95
7821,12,61000000,6652,6683,,31,170.53,7658937.101338432,5237438.95
7822,1,2315000,6662,6738,,76,170.53,3325419.7044334975,5237438.95
7823,1,35000000,6662,6742,,80,170.53,3325419.7044334975,5237438.95
7824,4,1000000,6694,6703,,9,159.56,4297914.794871795,6271224.19
7825,3,540000,6715,6737,,22,159.56,9246769.549865229,6271224.19
7826,12,15000,6798,6808,,10,159.56,7658937.101338432,6271224.19
7827,12,61000000,6819,6848,,29,159.56,7658937.101338432,6271224.19
7828,3,20000,6850,6878,,28,159.56,9246769.549865229,6271224.19
7829,20,11907705,6854,7054,,200,159.56,7597088.421768707,6271224.19
7830,12,357050,7002,7019,,17,159.56,7658937.101338432,6271224.19
7831,3,800000,7071,7096,,25,155.74,9246769.549865229,6918446.56
7832,12,1500000,7099,7143,,44,155.74,7658937.101338432,6918446.56
7833,21,1800000,7220,7257,,37,155.74,17091199.984,6918446.56
7834,23,4500000,7283,7625,,342,155.74,5772926.70157068,6918446.56
7835,1,1600000,7296,7348,,52,155.74,3325419.7044334975,6918446.56
7836,1,55247926,7330,8839,,1509,155.74,3325419.7044334975,6918446.56
7837,24,10000,7439,7522,,83,152.24,23456062.532786883,6303424.81
7838,17,6700000,7516,7540,,24,152.24,1614143.0049603174,6303424.81
7839,21,3000000,7548,7633,,85,152.24,17091199.984,6303424.81
7840,0,1950000,7684,7775,,91,152.24,8418173.322222222,6303424.81
7841,3,5000000,7760,7768,,8,152.24,9246769.549865229,6303424.81
7842,0,1950000,7821,8012,,191,120.16,8418173.322222222,3586324.4
7843,1,1950000,7821,7913,,92,120.16,3325419.7044334975,3586324.4
7844,23,1600000,7841,7969,,128,120.16,5772926.70157068,3586324.4
7845,22,250000,7851,7982,,131,120.16,2904103.2512077293,3586324.4
7846,24,20000,7854,7872,,18,120.16,23456062.532786883,3586324.4
7847,1,1000000,7864,7898,,34,120.16,3325419.7044334975,3586324.4
7848,0,1950000,7864,8220,,356,120.16,8418173.322222222,3586324.4
7849,20,1500000,7865,7943,,78,120.16,7597088.421768707,3586324.4
7850,20,1500000,7869,7943,,74,120.16,7597088.421768707,3586324.4
7851,24,600000,7871,7908,,37,120.16,23456062.532786883,3586324.4
7852,12,22000000,7902,7961,,59,120.16,7658937.101338432,3586324.4
7853,1,1300000,7921,8019,,98,120.16,3325419.7044334975,3586324.4
7854,20,750000,7921,8040,,119,120.16,7597088.421768707,3586324.4
7855,20,750000,7922,8037,,115,120.16,7597088.421768707,3586324.4
7856,20,750000,7922,8038,,116,120.16,7597088.421768707,3586324.4
7857,20,750000,7922,8038,,116,120.16,7597088.421768707,3586324.4
7858,20,750000,7926,7957,,31,120.16,7597088.421768707,3586324.4
7859,20,750000,7926,7957,,31,120.16,7597088.421768707,3586324.4
7860,20,750000,7926,7957,,31,120.16,7597088.421768707,3586324.4
7861,20,750000,7926,7962,,36,120.16,7597088.421768707,3586324.4
7862,14,1300000,7939,8019,,80,120.16,5826416.914893617,3586324.4
7863,20,750000,7949,7976,,27,120.16,7597088.421768707,3586324.4
7864,20,750000,7949,7976,,27,120.16,7597088.421768707,3586324.4
7865,3,16900000,7949,8038,,89,120.16,9246769.549865229,3586324.4
7866,24,30000000,7983,8221,,238,120.16,23456062.532786883,3586324.4
7867,20,750000,8027,8369,,342,120.16,7597088.421768707,3586324.4
7868,20,750000,8027,8369,,342,120.16,7597088.421768707,3586324.4
7869,20,750000,8030,8349,,319,120.16,7597088.421768707,3586324.4
7870,20,750000,8030,8349,,319,120.16,7597088.421768707,3586324.4
7871,20,750000,8032,8361,,329,120.16,7597088.421768707,3586324.4
7872,20,750000,8032,8361,,329,120.16,7597088.421768707,3586324.4
7873,20,750000,8046,8457,,411,120.16,7597088.421768707,3586324.4
7874,20,750000,8046,8464,,418,120.16,7597088.421768707,3586324.4
7875,20,75000,8046,8363,,317,120.16,7597088.421768707,3586324.4
7876,20,75000,8046,8363,,317,120.16,7597088.421768707,3586324.4
7877,20,750000,8046,8457,,411,120.16,7597088.421768707,3586324.4
7878,20,750000,8046,8464,,418,120.16,7597088.421768707,3586324.4
7879,11,6080625,8083,8115,,32,120.16,1820371.57,3586324.4
7880,3,19225000,8093,8205,,112,120.16,9246769.549865229,3586324.4
7881,17,1500000,8094,8130,,36,120.16,1614143.0049603174,3586324.4
7882,11,160000,8094,8110,,16,120.16,1820371.57,3586324.4
7883,20,750000,8114,8384,,270,120.16,7597088.421768707,3586324.4
7884,20,750000,8114,8384,,270,120.16,7597088.421768707,3586324.4
7885,20,750000,8167,8382,,215,99.44,7597088.421768707,1975331.43
7886,20,750000,8167,8381,,214,99.44,7597088.421768707,1975331.43
7887,20,750000,8173,8384,,211,99.44,7597088.421768707,1975331.43
7888,20,750000,8174,8401,,227,99.44,7597088.421768707,1975331.43
7889,20,750000,8174,8377,,203,99.44,7597088.421768707,1975331.43
7890,20,750000,8174,8376,,202,99.44,7597088.421768707,1975331.43
7891,4,150000,8195,8223,,28,99.44,4297914.794871795,1975331.43
7892,5,503302,8216,8255,,39,99.44,1400922.5020242915,1975331.43
7893,24,17000000,8229,8265,,36,99.44,23456062.532786883,1975331.43
7894,2,17000000,8234,8265,,31,99.44,2989003.2716499544,1975331.43
7895,23,480000,8248,8285,,37,99.44,5772926.70157068,1975331.43
7896,24,690000,8257,8285,,28,99.44,23456062.532786883,1975331.43
7897,1,250000,8261,8277,,16,99.44,3325419.7044334975,1975331.43
7898,3,808760,8270,8522,,252,99.44,9246769.549865229,1975331.43
7899,20,711864,8270,8860,,590,99.44,7597088.421768707,1975331.43
7900,22,100000000,8279,8444,,165,99.44,2904103.2512077293,1975331.43
7901,13,7500000,8282,8646,,364,99.44,7795654.71978022,1975331.43
7902,0,500000,8305,8437,,132,99.44,8418173.322222222,1975331.43
7903,15,85000000,8346,8886,,540,99.44,4522577.48037889,1975331.43
7904,15,5000,8355,8382,,27,99.44,4522577.48037889,1975331.43
7905,5,8600000,8374,8509,,135,99.44,1400922.5020242915,1975331.43
7906,5,8600000,8418,8888,,470,99.44,1400922.5020242915,1975331.43
7907,22,50000,8426,8465,,39,99.44,2904103.2512077293,1975331.43
7908,19,100000,8446,8473,,27,99.44,6721340.5708154505,1975331.43
7909,12,100000,8446,8528,,82,99.44,7658937.101338432,1975331.43
7910,17,200000,8451,8482,,31,99.44,1614143.0049603174,1975331.43
7911,12,200000,8459,8523,,64,99.44,7658937.101338432,1975331.43
7912,11,150000,8466,8510,,44,99.44,1820371.57,1975331.43
7913,17,150000,8472,8507,,35,99.44,1614143.0049603174,1975331.43
7914,1,1000,8473,8507,,34,99.44,3325419.7044334975,1975331.43
7915,22,150000,8502,8531,,29,65.64,2904103.2512077293,1503028.14
7916,17,150000,8502,8516,,14,65.64,1614143.0049603174,1503028.14
7917,11,500000,8580,8619,,39,65.64,1820371.57,1503028.14
7918,3,500000,8583,8613,,30,65.64,9246769.549865229,1503028.14
7919,24,150000,8730,8779,,49,65.64,23456062.532786883,1503028.14
7920,0,70000,8783,8835,,52,65.64,8418173.322222222,1503028.14
7921,24,15000000,8797,8892,,95,65.64,23456062.532786883,1503028.14
7922,17,190000,8808,8836,,28,65.64,1614143.0049603174,1503028.14
7923,1,190000,8808,8835,,27,65.64,3325419.7044334975,1503028.14
7924,24,190000,8808,8811,,3,65.64,23456062.532786883,1503028.14
7925,12,190000,8808,8837,,29,65.64,7658937.101338432,1503028.14
7926,1,190000,8808,8835,,27,65.64,3325419.7044334975,1503028.14
7927,17,190000,8808,8836,,28,65.64,1614143.0049603174,1503028.14
7928,12,190000,8808,8837,,29,65.64,7658937.101338432,1503028.14
7929,3,190000,8815,8846,,31,65.64,9246769.549865229,1503028.14
7930,24,190000,8815,8846,,31,65.64,23456062.532786883,1503028.14
7931,21,190000,8815,8859,,44,65.64,17091199.984,1503028.14
7932,11,190000,8815,8853,,38,65.64,1820371.57,1503028.14
7933,24,285000,8821,8892,,71,65.64,23456062.532786883,1503028.14
7934,0,300000,8866,8914,,48,29.02,8418173.322222222,3613519.51
7935,0,12000,8866,8879,,13,29.02,8418173.322222222,3613519.51
7936,5,100000,8891,8901,,10,29.02,1400922.5020242915,3613519.51
7937,1,13500000,8893,8922,,29,29.02,3325419.7044334975,3613519.51
7938,5,4300000,1300,1486,6304,186,219.0,1400922.5020242915,7652071.6
7939,1,3600000,3945,4370,6609,425,312.72,3325419.7044334975,13350024.59
7940,1,3600000,3945,4370,6609,425,312.72,3325419.7044334975,13350024.59
7941,1,3600000,3945,4370,6609,425,312.72,3325419.7044334975,13350024.59
7942,0,110000000,4054,6466,7136,2412,312.72,8418173.322222222,13350024.59
7943,0,205000000,4190,4757,7164,567,248.15,8418173.322222222,12693718.64
7944,1,350000,5049,5112,6421,63,253.83,3325419.7044334975,6984378.81
7945,17,1500000,5287,5308,8914,21,246.12,1614143.0049603174,6701891.81
7946,11,1500000,5310,5525,8914,215,246.12,1820371.57,6701891.81
7947,24,980000,5638,5946,6646,308,104.75,23456062.532786883,3369660.19
7948,23,50000,5666,5680,8467,14,104.75,5772926.70157068,3369660.19
7949,11,400000,5919,5975,6436,56,104.75,1820371.57,3369660.19
7950,0,50000,6001,6589,6618,588,141.64,8418173.322222222,5089136.37
7951,1,75000,6004,6126,6428,122,141.64,3325419.7044334975,5089136.37
7952,24,100000,6044,6123,7302,79,141.64,23456062.532786883,5089136.37
7953,17,1700000,6065,7642,8915,1577,141.64,1614143.0049603174,5089136.37
7954,11,500000,6093,6133,6806,40,141.64,1820371.57,5089136.37
7955,24,100000,6127,6161,6400,34,141.64,23456062.532786883,5089136.37
7956,17,20000000,6160,7768,8866,1608,141.64,1614143.0049603174,5089136.37
7957,23,23000,6178,6476,6519,298,141.64,5772926.70157068,5089136.37
7958,1,430000,6199,6336,7738,137,141.64,3325419.7044334975,5089136.37
7959,12,16700000,6214,7981,8866,1767,141.64,7658937.101338432,5089136.37
7960,17,40000,6219,6224,6715,5,141.64,1614143.0049603174,5089136.37
7961,12,23127300,6225,7733,8866,1508,141.64,7658937.101338432,5089136.37
7962,21,730034,6226,6262,6637,36,141.64,17091199.984,5089136.37
7963,5,184000,6262,6290,7327,28,141.64,1400922.5020242915,5089136.37
7964,23,455000,6287,6305,6855,18,141.64,5772926.70157068,5089136.37
7965,14,250000,6352,6374,6707,22,170.53,5826416.914893617,5237438.95
7966,23,4900000,6359,6387,7285,28,170.53,5772926.70157068,5237438.95
7967,2,400000,6364,6389,7368,25,170.53,2989003.2716499544,5237438.95
7968,24,300000,6367,6373,7430,6,170.53,23456062.532786883,5237438.95
7969,17,5500000,6400,6444,7456,44,170.53,1614143.0049603174,5237438.95
7970,24,1300000,6487,6547,7117,60,170.53,23456062.532786883,5237438.95
7971,24,10000000,6493,6651,8342,158,170.53,23456062.532786883,5237438.95
7972,9,300000,6499,6529,7318,30,170.53,3707403.8834951455,5237438.95
7973,15,999999,6505,6532,7318,27,170.53,4522577.48037889,5237438.95
7974,13,1000000,6512,6535,7318,23,170.53,7795654.71978022,5237438.95
7975,12,1300000,6512,6526,7318,14,170.53,7658937.101338432,5237438.95
7976,15,1500000,6512,6532,7117,20,170.53,4522577.48037889,5237438.95
7977,23,1000000,6536,6568,7318,32,170.53,5772926.70157068,5237438.95
7978,21,1000000,6536,6555,7318,19,170.53,17091199.984,5237438.95
7979,5,300000,6540,6561,6825,21,170.53,1400922.5020242915,5237438.95
7980,3,999999,6540,6542,7318,2,170.53,9246769.549865229,5237438.95
7981,9,1000000,6543,6569,7114,26,170.53,3707403.8834951455,5237438.95
7982,18,1000000,6543,6563,7114,20,170.53,8584355.493548388,5237438.95
7983,21,1000000,6543,6549,7318,6,170.53,17091199.984,5237438.95
7984,5,260000,6547,6575,7008,28,170.53,1400922.5020242915,5237438.95
7985,21,1000000,6554,6590,7318,36,170.53,17091199.984,5237438.95
7986,3,1000000,6554,6578,7327,24,170.53,9246769.549865229,5237438.95
7987,17,1000000,6556,6700,7114,144,170.53,1614143.0049603174,5237438.95
7988,21,1000000,6564,6575,7318,11,170.53,17091199.984,5237438.95
7989,24,1000000,6564,6571,7318,7,170.53,23456062.532786883,5237438.95
7990,3,1000000,6564,6596,7318,32,170.53,9246769.549865229,5237438.95
7991,3,100000,6574,6596,7318,22,170.53,9246769.549865229,5237438.95
7992,4,40000,6576,6591,7072,15,170.53,4297914.794871795,5237438.95
7993,11,1000000,6584,6585,7318,1,170.53,1820371.57,5237438.95
7994,24,1000000,6584,6611,7117,27,170.53,23456062.532786883,5237438.95
7995,3,1000000,6584,6620,7318,36,170.53,9246769.549865229,5237438.95
7996,12,999999,6605,6638,7318,33,170.53,7658937.101338432,5237438.95
7997,2,1000000,6612,6662,7318,50,170.53,2989003.2716499544,5237438.95
7998,2,1000000,6613,6648,7114,35,170.53,2989003.2716499544,5237438.95
7999,3,200000,6616,6652,7786,36,170.53,9246769.549865229,5237438.95
8000,3,1000000,6661,6686,7117,25,170.53,9246769.549865229,5237438.95
8001,3,1000000,6661,6687,7114,26,170.53,9246769.549865229,5237438.95
8002,13,1000000,6661,6693,7318,32,170.53,7795654.71978022,5237438.95
8003,12,1000000,6661,6689,7318,28,170.53,7658937.101338432,5237438.95
8004,3,1000000,6661,6695,7318,34,170.53,9246769.549865229,5237438.95
8005,21,1000000,6661,6683,7318,22,170.53,17091199.984,5237438.95
8006,23,1000000,6661,6693,7114,32,170.53,5772926.70157068,5237438.95
8007,13,1000000,6662,6693,7318,31,170.53,7795654.71978022,5237438.95
8008,13,1000000,6662,6693,7318,31,170.53,7795654.71978022,5237438.95
8009,4,1000000,6662,6693,7318,31,170.53,4297914.794871795,5237438.95
8010,18,1000000,6662,6694,7318,32,170.53,8584355.493548388,5237438.95
8011,3,1000000,6662,6673,7117,11,170.53,9246769.549865229,5237438.95
8012,21,1000000,6662,6681,7318,19,170.53,17091199.984,5237438.95
8013,17,1000000,6662,6793,7117,131,170.53,1614143.0049603174,5237438.95
8014,23,1000000,6662,6693,7318,31,170.53,5772926.70157068,5237438.95
8015,20,1000000,6662,6693,7318,31,170.53,7597088.421768707,5237438.95
8016,1,1000000,6662,6989,7318,327,170.53,3325419.7044334975,5237438.95
8017,17,1000000,6662,6689,7318,27,170.53,1614143.0049603174,5237438.95
8018,17,1000000,6662,6750,7318,88,170.53,1614143.0049603174,5237438.95
8019,23,1000000,6662,6693,7318,31,170.53,5772926.70157068,5237438.95
8020,15,1000000,6662,6688,7117,26,170.53,4522577.48037889,5237438.95
8021,18,1000000,6676,6690,7114,14,159.56,8584355.493548388,6271224.19
8022,18,5000000,6676,6700,7318,24,159.56,8584355.493548388,6271224.19
8023,20,1000000,6686,6703,7318,17,159.56,7597088.421768707,6271224.19
8024,13,100000,6686,6701,7318,15,159.56,7795654.71978022,6271224.19
8025,15,1000000,6686,6711,7318,25,159.56,4522577.48037889,6271224.19
8026,12,1000000,6686,6763,7318,77,159.56,7658937.101338432,6271224.19
8027,2,400000,6694,6725,7911,31,159.56,2989003.2716499544,6271224.19
8028,23,1000000,6694,6700,7117,6,159.56,5772926.70157068,6271224.19
8029,3,1000000,6694,6738,7318,44,159.56,9246769.549865229,6271224.19
8030,1,1000000,6694,6750,7318,56,159.56,3325419.7044334975,6271224.19
8031,5,1000000,6694,6723,7318,29,159.56,1400922.5020242915,6271224.19
8032,17,1000000,6694,6750,7318,56,159.56,1614143.0049603174,6271224.19
8033,9,1000000,6694,6723,7318,29,159.56,3707403.8834951455,6271224.19
8034,3,1000000,6694,6700,7318,6,159.56,9246769.549865229,6271224.19
8035,8,1000000,6694,6723,7144,29,159.56,1501617.2191780822,6271224.19
8036,9,1000000,6694,6723,7114,29,159.56,3707403.8834951455,6271224.19
8037,5,1000000,6694,6723,7318,29,159.56,1400922.5020242915,6271224.19
8038,2,1000000,6694,6717,7318,23,159.56,2989003.2716499544,6271224.19
8039,20,200000,6731,7093,8751,362,159.56,7597088.421768707,6271224.19
8040,20,200000,6739,7093,8751,354,159.56,7597088.421768707,6271224.19
8041,24,3000000,6759,6961,8429,202,159.56,23456062.532786883,6271224.19
8042,23,6970000,6767,6806,7516,39,159.56,5772926.70157068,6271224.19
8043,12,61000000,6879,6918,7697,39,159.56,7658937.101338432,6271224.19
8044,20,1000000,6890,6898,7318,8,159.56,7597088.421768707,6271224.19
8045,4,1000000,6890,6904,6939,14,159.56,4297914.794871795,6271224.19
8046,22,115000,6946,7334,7544,388,159.56,2904103.2512077293,6271224.19
8047,12,115000,6946,7334,7544,388,159.56,7658937.101338432,6271224.19
8048,8,115000,6983,7298,7515,315,159.56,1501617.2191780822,6271224.19
8049,8,275000,6983,7178,7536,195,159.56,1501617.2191780822,6271224.19
8050,2,1680000,7016,7073,8824,57,159.56,2989003.2716499544,6271224.19
8051,7,10600000,7032,7057,7845,25,155.74,3738553.685483871,6918446.56
8052,11,300000,7050,7071,7918,21,155.74,1820371.57,6918446.56
8053,13,2000000,7061,7100,7676,39,155.74,7795654.71978022,6918446.56
8054,5,200000,7092,7110,8751,18,155.74,1400922.5020242915,6918446.56
8055,15,1250000,7096,7129,7920,33,155.74,4522577.48037889,6918446.56
8056,23,614000,7100,7128,8047,28,155.74,5772926.70157068,6918446.56
8057,20,380000,7121,7145,7547,24,155.74,7597088.421768707,6918446.56
8058,11,200000,7136,7292,7570,156,155.74,1820371.57,6918446.56
8059,2,300000,7149,7163,7745,14,155.74,2989003.2716499544,6918446.56
8060,3,500000,7157,7184,7876,27,155.74,9246769.549865229,6918446.56
8061,7,6200000,7177,7291,8748,114,155.74,3738553.685483871,6918446.56
8062,0,80000000,7242,8082,8825,840,155.74,8418173.322222222,6918446.56
8063,24,365000,7291,7352,7801,61,155.74,23456062.532786883,6918446.56
8064,20,390000,7297,7327,7544,30,155.74,7597088.421768707,6918446.56
8065,20,390000,7297,7327,7544,30,155.74,7597088.421768707,6918446.56
8066,24,1352000,7306,7317,8191,11,155.74,23456062.532786883,6918446.56
8067,24,160000,7306,7312,8201,6,155.74,23456062.532786883,6918446.56
8068,11,200000,7327,7369,7564,42,155.74,1820371.57,6918446.56
8069,2,200000,7334,7386,7575,52,155.74,2989003.2716499544,6918446.56
8070,24,300000,7353,7355,7801,2,155.74,23456062.532786883,6918446.56
8071,18,160000,7410,7431,7548,21,152.24,8584355.493548388,6303424.81
8072,12,30000,7554,7557,7655,3,152.24,7658937.101338432,6303424.81
8073,3,300000,7582,7689,8767,107,152.24,9246769.549865229,6303424.81
8074,4,600000,7911,7940,8453,29,120.16,4297914.794871795,3586324.4
8075,24,100000,8383,8415,8627,32,99.44,23456062.532786883,1975331.43
8076,17,10000,324,984,6234,660,184.47,1614143.0049603174,9047699.97
8077,24,60000,998,998,6140,0,140.14,23456062.532786883,7336579.66
8078,13,650000,1605,1698,5952,93,423.81,7795654.71978022,11229609.36
8079,15,10000,1892,1949,5962,57,423.81,4522577.48037889,11229609.36
8080,24,1400000,1990,2077,6093,87,166.1,23456062.532786883,3498084.51
8081,17,35000,2620,2636,6298,16,230.03,1614143.0049603174,14812242.86
8082,13,1000,2629,2717,5952,88,230.03,7795654.71978022,14812242.86
8083,13,300000,2754,2768,5955,14,417.96,7795654.71978022,14954908.92
8084,13,40000,3475,3495,6149,20,205.39,7795654.71978022,9006193.27
8085,14,50000,4020,4126,6288,106,312.72,5826416.914893617,13350024.59
8086,0,25000,4254,4266,6107,12,248.15,8418173.322222222,12693718.64
8087,15,60000,4455,4503,5951,48,248.15,4522577.48037889,12693718.64
8088,3,300000,4580,4594,6113,14,258.28,9246769.549865229,7314077.5
8089,12,50000,5294,5302,6014,8,246.12,7658937.101338432,6701891.81
8090,9,600000,5324,5482,6000,158,246.12,3707403.8834951455,6701891.81
8091,14,200000,5331,5353,6140,22,246.12,5826416.914893617,6701891.81
8092,12,50000,5365,5379,6004,14,246.12,7658937.101338432,6701891.81
8093,23,175000,5434,5462,5958,28,246.12,5772926.70157068,6701891.81
8094,8,700000,5538,5835,6115,297,246.12,1501617.2191780822,6701891.81
8095,1,350000,5702,5885,6179,183,104.75,3325419.7044334975,3369660.19
8096,7,500000,5702,5762,6078,60,104.75,3738553.685483871,3369660.19
8097,21,750000,5715,5731,5958,16,104.75,17091199.984,3369660.19
8098,24,650000,5743,5777,6207,34,104.75,23456062.532786883,3369660.19
8099,24,1000000,5785,5811,6031,26,104.75,23456062.532786883,3369660.19
8100,7,500000,5804,5833,6049,29,104.75,3738553.685483871,3369660.19
8101,2,300000,5846,5902,6112,56,104.75,2989003.2716499544,3369660.19
8102,23,50000,5849,5863,6287,14,104.75,5772926.70157068,3369660.19
8103,24,10000,5854,5868,5955,14,104.75,23456062.532786883,3369660.19
8104,9,10000,5888,5945,6039,57,104.75,3707403.8834951455,3369660.19
8105,2,40000,5899,5940,6119,41,104.75,2989003.2716499544,3369660.19
8106,0,83000,5902,6067,6176,165,104.75,8418173.322222222,3369660.19
8107,14,570000,5905,5969,6098,64,104.75,5826416.914893617,3369660.19
8108,21,30000,5917,5938,6007,21,104.75,17091199.984,3369660.19
8109,9,300000,5965,6143,6220,178,141.64,3707403.8834951455,5089136.37
8110,16,120000,5994,6000,6070,6,141.64,2465023.1840707962,5089136.37
8111,12,60000,6098,6134,6211,36,141.64,7658937.101338432,5089136.37
8112,21,60700,6129,6140,6291,11,141.64,17091199.984,5089136.37
8113,24,760000,152,233,,81,184.47,23456062.532786883,9047699.97
8114,3,200000,191,267,,76,184.47,9246769.549865229,9047699.97
8115,4,9241,199,205,,6,184.47,4297914.794871795,9047699.97
8116,12,200000,214,332,,118,184.47,7658937.101338432,9047699.97
8117,21,90000,218,263,,45,184.47,17091199.984,9047699.97
8118,15,20000,240,571,,331,184.47,4522577.48037889,9047699.97
8119,24,50000,288,291,,3,184.47,23456062.532786883,9047699.97
8120,3,10000,303,366,,63,184.47,9246769.549865229,9047699.97
8121,11,60000,325,359,,34,184.47,1820371.57,9047699.97
8122,19,4000000,338,418,,80,184.47,6721340.5708154505,9047699.97
8123,5,100000,388,410,,22,184.47,1400922.5020242915,9047699.97
8124,16,50000,395,586,,191,184.47,2465023.1840707962,9047699.97
8125,18,15000,444,451,,7,184.47,8584355.493548388,9047699.97
8126,22,200000,575,901,,326,202.94,2904103.2512077293,7117555.88
8127,12,2000,603,606,,3,202.94,7658937.101338432,7117555.88
8128,20,20000,704,704,,0,202.94,7597088.421768707,7117555.88
8129,4,400000,732,1051,,319,202.94,4297914.794871795,7117555.88
8130,19,60000,837,890,,53,140.14,6721340.5708154505,7336579.66
8131,18,300000,879,907,,28,140.14,8584355.493548388,7336579.66
8132,21,1700000,981,989,,8,140.14,17091199.984,7336579.66
8133,14,3000,981,981,,0,140.14,5826416.914893617,7336579.66
8134,14,70000,1031,1244,,213,140.14,5826416.914893617,7336579.66
8135,19,60000,1040,1074,,34,140.14,6721340.5708154505,7336579.66
8136,24,34000,1068,1075,,7,140.14,23456062.532786883,7336579.66
8137,24,25000,1093,1115,,22,140.14,23456062.532786883,7336579.66
8138,2,75000,1096,1146,,50,140.14,2989003.2716499544,7336579.66
8139,3,50000,1142,1150,,8,140.14,9246769.549865229,7336579.66
8140,3,3000000,1164,1170,,6,140.14,9246769.549865229,7336579.66
8141,24,50000,1257,1257,,0,219.0,23456062.532786883,7652071.6
8142,19,20000,1277,1312,,35,219.0,6721340.5708154505,7652071.6
8143,3,50000,1278,1312,,34,219.0,9246769.549865229,7652071.6
8144,3,1000000,1327,1339,,12,219.0,9246769.549865229,7652071.6
8145,2,85000,1376,1384,,8,219.0,2989003.2716499544,7652071.6
8146,24,180000,1464,1494,,30,219.0,23456062.532786883,7652071.6
8147,3,20000,1565,1565,,0,423.81,9246769.549865229,11229609.36
8148,8,8000,1586,2334,,748,423.81,1501617.2191780822,11229609.36
8149,19,130000,1587,1607,,20,423.81,6721340.5708154505,11229609.36
8150,19,500000,1591,1639,,48,423.81,6721340.5708154505,11229609.36
8151,24,10000,1698,1706,,8,423.81,23456062.532786883,11229609.36
8152,3,100000,1716,1719,,3,423.81,9246769.549865229,11229609.36
8153,18,220000,1773,1789,,16,423.81,8584355.493548388,11229609.36
8154,18,60000,1775,1782,,7,423.81,8584355.493548388,11229609.36
8155,3,25000,1811,1874,,63,423.81,9246769.549865229,11229609.36
8156,16,530000,1823,2215,,392,423.81,2465023.1840707962,11229609.36
8157,13,150000,1830,1874,,44,423.81,7795654.71978022,11229609.36
8158,12,54000,1892,1972,,80,423.81,7658937.101338432,11229609.36
8159,2,39000,1899,1906,,7,423.81,2989003.2716499544,11229609.36
8160,15,15000,1922,1996,,74,166.1,4522577.48037889,3498084.51
8161,3,150000,1934,1964,,30,166.1,9246769.549865229,3498084.51
8162,2,180000,1944,1985,,41,166.1,2989003.2716499544,3498084.51
8163,3,400000,1970,2026,,56,166.1,9246769.549865229,3498084.51
8164,3,5000,1992,2012,,20,166.1,9246769.549865229,3498084.51
8165,22,410000,2014,2489,,475,166.1,2904103.2512077293,3498084.51
8166,16,200000,2024,2305,,281,166.1,2465023.1840707962,3498084.51
8167,24,12000,2041,2292,,251,166.1,23456062.532786883,3498084.51
8168,3,400000,2062,2062,,0,166.1,9246769.549865229,3498084.51
8169,3,30000,2125,2139,,14,166.1,9246769.549865229,3498084.51
8170,13,80000,2138,2143,,5,166.1,7795654.71978022,3498084.51
8171,24,100000,2151,2216,,65,166.1,23456062.532786883,3498084.51
8172,4,75000,2160,2195,,35,166.1,4297914.794871795,3498084.51
8173,19,75000,2181,2193,,12,166.1,6721340.5708154505,3498084.51
8174,3,400000,2220,2306,,86,166.1,9246769.549865229,3498084.51
8175,24,900000,2223,2258,,35,166.1,23456062.532786883,3498084.51
8176,17,100000,2238,2245,,7,166.1,1614143.0049603174,3498084.51
8177,16,50000,2255,2286,,31,166.1,2465023.1840707962,3498084.51
8178,15,7000,2313,2686,,373,230.03,4522577.48037889,14812242.86
8179,3,12000000,2325,2635,,310,230.03,9246769.549865229,14812242.86
8180,12,25000,2363,2405,,42,230.03,7658937.101338432,14812242.86
8181,3,1000000,2371,2398,,27,230.03,9246769.549865229,14812242.86
8182,14,23000,2374,2402,,28,230.03,5826416.914893617,14812242.86
8183,11,120000,2395,2402,,7,230.03,1820371.57,14812242.86
8184,24,300000,2518,2535,,17,230.03,23456062.532786883,14812242.86
8185,11,30000,2523,2559,,36,230.03,1820371.57,14812242.86
8186,18,5000,2581,2584,,3,230.03,8584355.493548388,14812242.86
8187,22,130000,2585,2658,,73,230.03,2904103.2512077293,14812242.86
8188,3,350000,2622,2626,,4,230.03,9246769.549865229,14812242.86
8189,24,1000000,2705,2711,,6,417.96,23456062.532786883,14954908.92
8190,15,980000,2710,3279,,569,417.96,4522577.48037889,14954908.92
8191,24,1000000,2735,2739,,4,417.96,23456062.532786883,14954908.92
8192,17,8000,2741,2755,,14,417.96,1614143.0049603174,14954908.92
8193,15,300000,2753,2964,,211,417.96,4522577.48037889,14954908.92
8194,2,1120000,2760,2808,,48,417.96,2989003.2716499544,14954908.92
8195,11,200000,2808,2852,,44,417.96,1820371.57,14954908.92
8196,24,2000000,2916,2921,,5,417.96,23456062.532786883,14954908.92
8197,2,27741,2928,2952,,24,417.96,2989003.2716499544,14954908.92
8198,2,111000,2943,2978,,35,417.96,2989003.2716499544,14954908.92
8199,19,2000,3001,3125,,124,417.96,6721340.5708154505,14954908.92
8200,24,75000,3025,3041,,16,281.46,23456062.532786883,11503993.02
8201,2,70000,3033,3070,,37,281.46,2989003.2716499544,11503993.02
8202,24,160000,3054,3064,,10,281.46,23456062.532786883,11503993.02
8203,24,25000,3062,3064,,2,281.46,23456062.532786883,11503993.02
8204,11,50000,3099,3124,,25,281.46,1820371.57,11503993.02
8205,24,150000,3109,3111,,2,281.46,23456062.532786883,11503993.02
8206,11,100000,3120,3188,,68,281.46,1820371.57,11503993.02
8207,11,75000,3127,3154,,27,281.46,1820371.57,11503993.02
8208,24,25000,3130,3137,,7,281.46,23456062.532786883,11503993.02
8209,19,15000,3134,3337,,203,281.46,6721340.5708154505,11503993.02
8210,14,6000000,3140,3326,,186,281.46,5826416.914893617,11503993.02
8211,14,6000000,3141,3326,,185,281.46,5826416.914893617,11503993.02
8212,2,20000,3147,3161,,14,281.46,2989003.2716499544,11503993.02
8213,3,600000,3182,3186,,4,281.46,9246769.549865229,11503993.02
8214,3,50000,3210,3215,,5,281.46,9246769.549865229,11503993.02
8215,2,5000,3221,3232,,11,281.46,2989003.2716499544,11503993.02
8216,12,600000,3246,3277,,31,281.46,7658937.101338432,11503993.02
8217,24,40000,3272,3280,,8,281.46,23456062.532786883,11503993.02
8218,24,25000,3272,3309,,37,281.46,23456062.532786883,11503993.02
8219,2,12000000,3279,3393,,114,281.46,2989003.2716499544,11503993.02
8220,24,30000,3417,3434,,17,205.39,23456062.532786883,9006193.27
8221,1,450000,3489,3539,,50,205.39,3325419.7044334975,9006193.27
8222,5,1467000,3489,3614,,125,205.39,1400922.5020242915,9006193.27
8223,2,17500,3501,3516,,15,205.39,2989003.2716499544,9006193.27
8224,8,5000,3510,3784,,274,205.39,1501617.2191780822,9006193.27
8225,12,75000,3546,3595,,49,205.39,7658937.101338432,9006193.27
8226,22,1200000,3593,3690,,97,205.39,2904103.2512077293,9006193.27
8227,24,100000,3594,3602,,8,205.39,23456062.532786883,9006193.27
8228,14,40000,3602,3620,,18,205.39,5826416.914893617,9006193.27
8229,14,250000,3621,3655,,34,205.39,5826416.914893617,9006193.27
8230,3,235000,3650,3727,,77,205.39,9246769.549865229,9006193.27
8231,4,150000,3651,3691,,40,205.39,4297914.794871795,9006193.27
8232,13,15000,3684,3698,,14,205.39,7795654.71978022,9006193.27
8233,17,150000,3729,3790,,61,205.39,1614143.0049603174,9006193.27
8234,15,20000,3799,3819,,20,312.72,4522577.48037889,13350024.59
8235,14,10000,3820,3825,,5,312.72,5826416.914893617,13350024.59
8236,0,75000,3831,3908,,77,312.72,8418173.322222222,13350024.59
8237,10,30000,3840,3855,,15,312.72,8282326.220930233,13350024.59
8238,17,5000,3840,3855,,15,312.72,1614143.0049603174,13350024.59
8239,3,1250000,3917,3929,,12,312.72,9246769.549865229,13350024.59
8240,10,60000,3937,3953,,16,312.72,8282326.220930233,13350024.59
8241,19,80000,3998,4044,,46,312.72,6721340.5708154505,13350024.59
8242,10,35000,4034,4401,,367,312.72,8282326.220930233,13350024.59
8243,24,150000,4054,4062,,8,312.72,23456062.532786883,13350024.59
8244,10,22750,4064,4078,,14,312.72,8282326.220930233,13350024.59
8245,24,500000,4086,4124,,38,312.72,23456062.532786883,13350024.59
8246,19,25000,4142,4216,,74,248.15,6721340.5708154505,12693718.64
8247,24,22500,4181,4194,,13,248.15,23456062.532786883,12693718.64
8248,15,30000,4181,4205,,24,248.15,4522577.48037889,12693718.64
8249,19,900000,4191,4261,,70,248.15,6721340.5708154505,12693718.64
8250,11,65000,4198,4204,,6,248.15,1820371.57,12693718.64
8251,21,72500,4215,4229,,14,248.15,17091199.984,12693718.64
8252,24,60000,4244,4264,,20,248.15,23456062.532786883,12693718.64
8253,17,200000,4260,4274,,14,248.15,1614143.0049603174,12693718.64
8254,17,60000,4303,4331,,28,248.15,1614143.0049603174,12693718.64
8255,23,900000,4331,4448,,117,248.15,5772926.70157068,12693718.64
8256,16,250000,4365,4456,,91,248.15,2465023.1840707962,12693718.64
8257,15,100000,4376,4405,,29,248.15,4522577.48037889,12693718.64
8258,18,85000,4394,4418,,24,248.15,8584355.493548388,12693718.64
8259,3,70000,4426,4457,,31,248.15,9246769.549865229,12693718.64
8260,10,5000,4427,4455,,28,248.15,8282326.220930233,12693718.64
8261,0,150000,4456,4617,,161,248.15,8418173.322222222,12693718.64
8262,24,100000,4484,4504,,20,258.28,23456062.532786883,7314077.5
8263,9,250000,4485,4580,,95,258.28,3707403.8834951455,7314077.5
8264,24,100000,4546,4551,,5,258.28,23456062.532786883,7314077.5
8265,1,1200000,4551,4600,,49,258.28,3325419.7044334975,7314077.5
8266,10,20000,4554,4576,,22,258.28,8282326.220930233,7314077.5
8267,20,25000,4600,4652,,52,258.28,7597088.421768707,7314077.5
8268,13,65000,4609,5120,,511,258.28,7795654.71978022,7314077.5
8269,2,1095000,4645,4693,,48,258.28,2989003.2716499544,7314077.5
8270,10,50000,4670,4686,,16,258.28,8282326.220930233,7314077.5
8271,20,30000,4688,4737,,49,258.28,7597088.421768707,7314077.5
8272,3,400000,4712,4793,,81,258.28,9246769.549865229,7314077.5
8273,1,15000000,5078,5143,,65,253.83,3325419.7044334975,6984378.81
8274,12,250000,4814,4924,,110,258.28,7658937.101338432,7314077.5
8275,7,50000,4817,5657,,840,258.28,3738553.685483871,7314077.5
8276,3,500000,4824,4856,,32,258.28,9246769.549865229,7314077.5
8277,24,350000,4848,4881,,33,253.83,23456062.532786883,6984378.81
8278,17,75000,4854,4925,,71,253.83,1614143.0049603174,6984378.81
8279,11,100000,4856,4866,,10,253.83,1820371.57,6984378.81
8280,15,60000,4874,4903,,29,253.83,4522577.48037889,6984378.81
8281,23,350000,4875,4890,,15,253.83,5772926.70157068,6984378.81
8282,16,160000,4891,4936,,45,253.83,2465023.1840707962,6984378.81
8283,20,250000,4904,4964,,60,253.83,7597088.421768707,6984378.81
8284,24,75000,4911,4950,,39,253.83,23456062.532786883,6984378.81
8285,0,34000000,4922,5155,,233,253.83,8418173.322222222,6984378.81
8286,13,200000,4925,5000,,75,253.83,7795654.71978022,6984378.81
8287,19,200000,4954,5058,,104,253.83,6721340.5708154505,6984378.81
8288,11,76750,4960,4999,,39,253.83,1820371.57,6984378.81
8289,3,25000,4965,4985,,20,253.83,9246769.549865229,6984378.81
8290,24,150000,5009,5016,,7,253.83,23456062.532786883,6984378.81
8291,23,30000,5009,5023,,14,253.83,5772926.70157068,6984378.81
8292,3,60000,5029,5057,,28,253.83,9246769.549865229,6984378.81
8293,20,30000,5030,5077,,47,253.83,7597088.421768707,6984378.81
8294,21,100000,5035,5048,,13,253.83,17091199.984,6984378.81
8295,15,1300000,5063,5169,,106,253.83,4522577.48037889,6984378.81
8296,17,30000,5078,5107,,29,253.83,1614143.0049603174,6984378.81
8297,17,80000,5098,5104,,6,253.83,1614143.0049603174,6984378.81
8298,16,40000,5128,5135,,7,253.83,2465023.1840707962,6984378.81
8299,0,20000,5140,5148,,8,253.83,8418173.322222222,6984378.81
8300,14,150000,5234,5258,,24,246.12,5826416.914893617,6701891.81
8301,24,101560,5254,5288,,34,246.12,23456062.532786883,6701891.81
8302,12,100000,5308,5406,,98,246.12,7658937.101338432,6701891.81
8303,5,60000,5310,5392,,82,246.12,1400922.5020242915,6701891.81
8304,20,320000,5328,5370,,42,246.12,7597088.421768707,6701891.81
8305,21,50000,5332,5363,,31,246.12,17091199.984,6701891.81
8306,21,300000,5332,5378,,46,246.12,17091199.984,6701891.81
8307,1,80000,5378,5416,,38,246.12,3325419.7044334975,6701891.81
8308,24,10000,5393,5478,,85,246.12,23456062.532786883,6701891.81
8309,23,65000,5426,5471,,45,246.12,5772926.70157068,6701891.81
8310,3,20000,5437,5440,,3,246.12,9246769.549865229,6701891.81
8311,15,165000,5437,5454,,17,246.12,4522577.48037889,6701891.81
8312,15,195000,5520,5588,,68,246.12,4522577.48037889,6701891.81
8313,24,11000,5520,5636,,116,246.12,23456062.532786883,6701891.81
8314,10,30000,5552,5590,,38,246.12,8282326.220930233,6701891.81
8315,13,50000,5568,5582,,14,246.12,7795654.71978022,6701891.81
8316,15,70000,5629,5687,,58,104.75,4522577.48037889,3369660.19
8317,23,500000,5667,5710,,43,104.75,5772926.70157068,3369660.19
8318,1,30000,5685,5738,,53,104.75,3325419.7044334975,3369660.19
8319,17,416800,5692,5786,,94,104.75,1614143.0049603174,3369660.19
8320,4,267000,5787,5815,,28,104.75,4297914.794871795,3369660.19
8321,21,93000,5801,5826,,25,104.75,17091199.984,3369660.19
8322,24,50000,5849,5863,,14,104.75,23456062.532786883,3369660.19
8323,21,50000,5849,5869,,20,104.75,17091199.984,3369660.19
8324,5,8000,5875,5994,,119,104.75,1400922.5020242915,3369660.19
8325,0,20000,5882,5902,,20,104.75,8418173.322222222,3369660.19
8326,14,4300000,5892,5951,,59,104.75,5826416.914893617,3369660.19
8327,5,8000,5966,5994,,28,141.64,1400922.5020242915,5089136.37
8328,23,50000,5989,6029,,40,141.64,5772926.70157068,5089136.37
8329,3,525000,6028,6044,,16,141.64,9246769.549865229,5089136.37
8330,24,30000,6044,6078,,34,141.64,23456062.532786883,5089136.37
8331,24,50000,6060,6091,,31,141.64,23456062.532786883,5089136.37
8332,23,190000,6072,6087,,15,141.64,5772926.70157068,5089136.37
8333,1,200000,6137,6221,,84,141.64,3325419.7044334975,5089136.37
8334,8,50000,6157,6172,,15,141.64,1501617.2191780822,5089136.37
8335,21,75000,6172,6248,,76,141.64,17091199.984,5089136.37
8336,19,75000,6200,6288,,88,141.64,6721340.5708154505,5089136.37
8337,24,100000,6246,6255,,9,141.64,23456062.532786883,5089136.37
8338,3,250000,6252,6336,,84,141.64,9246769.549865229,5089136.37
8339,3,400000,6269,6289,,20,141.64,9246769.549865229,5089136.37
8340,24,400000,6284,6325,,41,141.64,23456062.532786883,5089136.37
8341,12,40000,6380,6434,,54,170.53,7658937.101338432,5237438.95
8342,23,8000,6425,6445,,20,170.53,5772926.70157068,5237438.95
8343,15,3631000,6434,6442,,8,170.53,4522577.48037889,5237438.95
8344,1,300000,6445,6492,,47,170.53,3325419.7044334975,5237438.95
8345,24,300000,6484,6500,,16,170.53,23456062.532786883,5237438.95
8346,2,6500,6491,6506,,15,170.53,2989003.2716499544,5237438.95
8347,24,50000,6493,6500,,7,170.53,23456062.532786883,5237438.95
8348,19,60000,6506,6562,,56,170.53,6721340.5708154505,5237438.95
8349,9,500000,6513,6584,,71,170.53,3707403.8834951455,5237438.95
8350,9,200000,6554,6592,,38,170.53,3707403.8834951455,5237438.95
8351,2,20000,6556,6631,,75,170.53,2989003.2716499544,5237438.95
8352,18,150000,6617,6667,,50,170.53,8584355.493548388,5237438.95
8353,7,2000,6630,6644,,14,170.53,3738553.685483871,5237438.95
8354,19,30000,6697,6743,,46,159.56,6721340.5708154505,6271224.19
8355,11,24250,6697,6730,,33,159.56,1820371.57,6271224.19
8356,3,5000000,6702,6770,,68,159.56,9246769.549865229,6271224.19
8357,18,750000,6716,6737,,21,159.56,8584355.493548388,6271224.19
8358,24,1000000,6725,6751,,26,159.56,23456062.532786883,6271224.19
8359,0,1100000,6729,6863,,134,159.56,8418173.322222222,6271224.19
8360,11,123500,6738,6802,,64,159.56,1820371.57,6271224.19
8361,24,500000,6742,6774,,32,159.56,23456062.532786883,6271224.19
8362,15,18000,6742,6772,,30,159.56,4522577.48037889,6271224.19
8363,1,1000000,6750,6836,,86,159.56,3325419.7044334975,6271224.19
8364,0,500000,6750,6828,,78,159.56,8418173.322222222,6271224.19
8365,3,200000,6758,6896,,138,159.56,9246769.549865229,6271224.19
8366,23,120000,6760,6834,,74,159.56,5772926.70157068,6271224.19
8367,3,2500,6794,6813,,19,159.56,9246769.549865229,6271224.19
8368,17,140000,6795,6872,,77,159.56,1614143.0049603174,6271224.19
8369,17,273205,6808,6851,,43,159.56,1614143.0049603174,6271224.19
8370,22,25000,6826,6862,,36,159.56,2904103.2512077293,6271224.19
8371,21,200000,6835,6848,,13,159.56,17091199.984,6271224.19
8372,24,200000,6842,6872,,30,159.56,23456062.532786883,6271224.19
8373,8,100000,6848,7015,,167,159.56,1501617.2191780822,6271224.19
8374,24,200000,6891,6927,,36,159.56,23456062.532786883,6271224.19
8375,21,10000,6953,7003,,50,159.56,17091199.984,6271224.19
8376,23,185500,6961,7004,,43,159.56,5772926.70157068,6271224.19
8377,12,150000,6976,7003,,27,159.56,7658937.101338432,6271224.19
8378,14,50000000,6988,8565,,1577,159.56,5826416.914893617,6271224.19
8379,14,50000000,6989,8565,,1576,159.56,5826416.914893617,6271224.19
8380,3,700000,6994,7037,,43,159.56,9246769.549865229,6271224.19
8381,4,16100000,7002,7731,,729,159.56,4297914.794871795,6271224.19
8382,24,100000,7026,7064,,38,159.56,23456062.532786883,6271224.19
8383,24,100000,7040,7082,,42,155.74,23456062.532786883,6918446.56
8384,24,100000,7044,7124,,80,155.74,23456062.532786883,6918446.56
8385,3,800000,7085,7143,,58,155.74,9246769.549865229,6918446.56
8386,23,100000,7096,7162,,66,155.74,5772926.70157068,6918446.56
8387,21,15000,7101,7115,,14,155.74,17091199.984,6918446.56
8388,2,100000,7106,7144,,38,155.74,2989003.2716499544,6918446.56
8389,23,1000000,7127,7660,,533,155.74,5772926.70157068,6918446.56
8390,19,4000000,7129,7228,,99,155.74,6721340.5708154505,6918446.56
8391,6,200000,7133,7150,,17,155.74,1124713.2781954887,6918446.56
8392,24,100000,7142,7213,,71,155.74,23456062.532786883,6918446.56
8393,20,250000,7148,7218,,70,155.74,7597088.421768707,6918446.56
8394,17,40000,7149,7456,,307,155.74,1614143.0049603174,6918446.56
8395,21,400000,7163,7183,,20,155.74,17091199.984,6918446.56
8396,24,150000,7172,7192,,20,155.74,23456062.532786883,6918446.56
8397,23,300000,7192,7221,,29,155.74,5772926.70157068,6918446.56
8398,17,100000,7199,7229,,30,155.74,1614143.0049603174,6918446.56
8399,21,500000,7206,7229,,23,155.74,17091199.984,6918446.56
8400,12,600000,7207,7243,,36,155.74,7658937.101338432,6918446.56
8401,22,10000,7219,7589,,370,155.74,2904103.2512077293,6918446.56
8402,20,90000,7222,7241,,19,155.74,7597088.421768707,6918446.56
8403,3,100000,7222,7278,,56,155.74,9246769.549865229,6918446.56
8404,22,10000,7243,7284,,41,155.74,2904103.2512077293,6918446.56
8405,15,800000,7260,7359,,99,155.74,4522577.48037889,6918446.56
8406,17,400000,7267,7285,,18,155.74,1614143.0049603174,6918446.56
8407,24,10000,7275,7297,,22,155.74,23456062.532786883,6918446.56
8408,11,12000000,7299,7379,,80,155.74,1820371.57,6918446.56
8409,3,50000,7312,7347,,35,155.74,9246769.549865229,6918446.56
8410,0,3500000,7324,7444,,120,155.74,8418173.322222222,6918446.56
8411,2,40000,7326,7368,,42,155.74,2989003.2716499544,6918446.56
8412,11,50000,7351,7369,,18,155.74,1820371.57,6918446.56
8413,11,20000,7353,7458,,105,155.74,1820371.57,6918446.56
8414,18,60000,7362,7436,,74,155.74,8584355.493548388,6918446.56
8415,4,100000,7369,7386,,17,155.74,4297914.794871795,6918446.56
8416,12,100000,7381,7719,,338,155.74,7658937.101338432,6918446.56
8417,3,75000,7387,7506,,119,155.74,9246769.549865229,6918446.56
8418,18,25000,7397,7421,,24,152.24,8584355.493548388,6303424.81
8419,15,150000,7407,7435,,28,152.24,4522577.48037889,6303424.81
8420,24,80000,7415,7446,,31,152.24,23456062.532786883,6303424.81
8421,5,300000,7417,7493,,76,152.24,1400922.5020242915,6303424.81
8422,24,150000,7429,7690,,261,152.24,23456062.532786883,6303424.81
8423,24,200000,7437,7519,,82,152.24,23456062.532786883,6303424.81
8424,12,4000000,7443,7536,,93,152.24,7658937.101338432,6303424.81
8425,3,250000,7452,7520,,68,152.24,9246769.549865229,6303424.81
8426,19,60000,7463,7527,,64,152.24,6721340.5708154505,6303424.81
8427,19,100000,7501,7528,,27,152.24,6721340.5708154505,6303424.81
8428,12,50000,7507,7534,,27,152.24,7658937.101338432,6303424.81
8429,11,13000,7527,7534,,7,152.24,1820371.57,6303424.81
8430,16,500000,7536,7828,,292,152.24,2465023.1840707962,6303424.81
8431,14,742000,7550,7614,,64,152.24,5826416.914893617,6303424.81
8432,24,9555000,7561,7599,,38,152.24,23456062.532786883,6303424.81
8433,16,1200000,7620,7652,,32,152.24,2465023.1840707962,6303424.81
8434,23,60000,7624,7808,,184,152.24,5772926.70157068,6303424.81
8435,11,11000,7626,7639,,13,152.24,1820371.57,6303424.81
8436,21,500000,7640,7792,,152,152.24,17091199.984,6303424.81
8437,7,12000,7649,7996,,347,152.24,3738553.685483871,6303424.81
8438,23,50000,7683,7747,,64,152.24,5772926.70157068,6303424.81
8439,3,30000,7705,7716,,11,152.24,9246769.549865229,6303424.81
8440,5,275000,7722,7737,,15,152.24,1400922.5020242915,6303424.81
8441,18,50000,7766,7793,,27,120.16,8584355.493548388,3586324.4
8442,19,80000,7773,7808,,35,120.16,6721340.5708154505,3586324.4
8443,2,3000000,7793,7845,,52,120.16,2989003.2716499544,3586324.4
8444,3,400000,7802,7814,,12,120.16,9246769.549865229,3586324.4
8445,14,40000,7807,7907,,100,120.16,5826416.914893617,3586324.4
8446,3,50000,7809,7815,,6,120.16,9246769.549865229,3586324.4
8447,9,45000,7838,7851,,13,120.16,3707403.8834951455,3586324.4
8448,21,499999,7898,7920,,22,120.16,17091199.984,3586324.4
8449,2,1500000,7926,7963,,37,120.16,2989003.2716499544,3586324.4
8450,5,20000,7962,7977,,15,120.16,1400922.5020242915,3586324.4
8451,18,150000,7967,8060,,93,120.16,8584355.493548388,3586324.4
8452,2,500000,7969,7985,,16,120.16,2989003.2716499544,3586324.4
8453,24,2000000,7993,8019,,26,120.16,23456062.532786883,3586324.4
8454,15,45000,7997,8017,,20,120.16,4522577.48037889,3586324.4
8455,22,310000,7999,8083,,84,120.16,2904103.2512077293,3586324.4
8456,8,750000,8019,8072,,53,120.16,1501617.2191780822,3586324.4
8457,24,200000,8025,8041,,16,120.16,23456062.532786883,3586324.4
8458,23,100000,8040,8132,,92,120.16,5772926.70157068,3586324.4
8459,12,100000,8040,8060,,20,120.16,7658937.101338432,3586324.4
8460,4,200000,8065,8081,,16,120.16,4297914.794871795,3586324.4
8461,24,2000000,8099,8157,,58,120.16,23456062.532786883,3586324.4
8462,24,11000000,8112,8284,,172,120.16,23456062.532786883,3586324.4
8463,14,2900000,8122,8853,,731,120.16,5826416.914893617,3586324.4
8464,14,2000000,8123,8857,,734,120.16,5826416.914893617,3586324.4
8465,14,8400000,8123,8864,,741,120.16,5826416.914893617,3586324.4
8466,14,4600000,8123,8858,,735,120.16,5826416.914893617,3586324.4
8467,24,10000,8131,8165,,34,99.44,23456062.532786883,1975331.43
8468,17,150000,8138,8152,,14,99.44,1614143.0049603174,1975331.43
8469,24,150000,8146,8163,,17,99.44,23456062.532786883,1975331.43
8470,3,100000,8185,8241,,56,99.44,9246769.549865229,1975331.43
8471,22,25000,8191,8244,,53,99.44,2904103.2512077293,1975331.43
8472,2,1300000,8194,8297,,103,99.44,2989003.2716499544,1975331.43
8473,15,80000,8199,8297,,98,99.44,4522577.48037889,1975331.43
8474,15,45000,8200,8227,,27,99.44,4522577.48037889,1975331.43
8475,1,200000,8291,8328,,37,99.44,3325419.7044334975,1975331.43
8476,24,100000000,8300,8318,,18,99.44,23456062.532786883,1975331.43
8477,3,900000,8347,8424,,77,99.44,9246769.549865229,1975331.43
8478,6,80000,8349,8424,,75,99.44,1124713.2781954887,1975331.43
8479,2,80000,8352,8482,,130,99.44,2989003.2716499544,1975331.43
8480,2,750000,8354,8382,,28,99.44,2989003.2716499544,1975331.43
8481,24,100000000,8369,8444,,75,99.44,23456062.532786883,1975331.43
8482,24,50000,8401,8416,,15,99.44,23456062.532786883,1975331.43
8483,18,1000000,8404,8436,,32,99.44,8584355.493548388,1975331.43
8484,21,500000,8465,8493,,28,99.44,17091199.984,1975331.43
8485,11,100000,8468,8534,,66,99.44,1820371.57,1975331.43
8486,21,800000,8479,8520,,41,99.44,17091199.984,1975331.43
8487,24,348000,8507,8527,,20,65.64,23456062.532786883,1503028.14
8488,6,60000,8534,8758,,224,65.64,1124713.2781954887,1503028.14
8489,17,320000,8536,8566,,30,65.64,1614143.0049603174,1503028.14
8490,4,120000,8550,8592,,42,65.64,4297914.794871795,1503028.14
8491,2,10000,8550,8578,,28,65.64,2989003.2716499544,1503028.14
8492,11,150000,8555,8635,,80,65.64,1820371.57,1503028.14
8493,2,1500000,8577,8607,,30,65.64,2989003.2716499544,1503028.14
8494,23,400000,8586,8639,,53,65.64,5772926.70157068,1503028.14
8495,3,425000,8597,8642,,45,65.64,9246769.549865229,1503028.14
8496,14,35000,8606,8614,,8,65.64,5826416.914893617,1503028.14
8497,16,1000000,8613,8732,,119,65.64,2465023.1840707962,1503028.14
8498,24,4500000,8614,8657,,43,65.64,23456062.532786883,1503028.14
8499,3,250000,8615,8622,,7,65.64,9246769.549865229,1503028.14
8500,24,70000,8620,8633,,13,65.64,23456062.532786883,1503028.14
8501,24,96000000,8627,8704,,77,65.64,23456062.532786883,1503028.14
8502,17,450000,8633,8738,,105,65.64,1614143.0049603174,1503028.14
8503,15,250000,8655,8689,,34,65.64,4522577.48037889,1503028.14
8504,4,1500000,8671,8689,,18,65.64,4297914.794871795,1503028.14
8505,12,100000,8676,8702,,26,65.64,7658937.101338432,1503028.14
8506,0,250000,8698,8789,,91,65.64,8418173.322222222,1503028.14
8507,11,150000,8710,8733,,23,65.64,1820371.57,1503028.14
8508,15,200000,8718,8781,,63,65.64,4522577.48037889,1503028.14
8509,19,80000,8719,8751,,32,65.64,6721340.5708154505,1503028.14
8510,24,65200000,8725,8786,,61,65.64,23456062.532786883,1503028.14
8511,23,300000,8727,8732,,5,65.64,5772926.70157068,1503028.14
8512,24,180000,8734,8864,,130,65.64,23456062.532786883,1503028.14
8513,3,75000,8738,8788,,50,65.64,9246769.549865229,1503028.14
8514,4,200000,8747,8776,,29,65.64,4297914.794871795,1503028.14
8515,17,1500000,8754,8804,,50,65.64,1614143.0049603174,1503028.14
8516,6,65000,8761,8782,,21,65.64,1124713.2781954887,1503028.14
8517,24,2000000,8761,8786,,25,65.64,23456062.532786883,1503028.14
8518,24,500000,8788,8821,,33,65.64,23456062.532786883,1503028.14
8519,10,160000,8810,8839,,29,65.64,8282326.220930233,1503028.14
8520,15,30000,8817,8822,,5,65.64,4522577.48037889,1503028.14
8521,24,850000,8817,8845,,28,65.64,23456062.532786883,1503028.14
8522,8,25000,8835,8865,,30,65.64,1501617.2191780822,1503028.14
8523,3,350000,8836,8873,,37,65.64,9246769.549865229,1503028.14
8524,21,900000,8839,8879,,40,65.64,17091199.984,1503028.14
8525,24,50000,8853,8908,,55,65.64,23456062.532786883,1503028.14
8526,3,50000,8865,8909,,44,29.02,9246769.549865229,3613519.51
8527,22,100000,8866,8873,,7,29.02,2904103.2512077293,3613519.51
8528,3,250000,8870,8916,,46,29.02,9246769.549865229,3613519.51
8529,5,150000,8877,8887,,10,29.02,1400922.5020242915,3613519.51
8530,24,300000,8885,8914,,29,29.02,23456062.532786883,3613519.51
8531,24,5000,8886,8915,,29,29.02,23456062.532786883,3613519.51
8532,14,87300,8886,8892,,6,29.02,5826416.914893617,3613519.51
8533,24,350000,8886,8894,,8,29.02,23456062.532786883,3613519.51
8534,9,100000,8888,8920,,32,29.02,3707403.8834951455,3613519.51
8535,23,1000,1,107,,106,179.4,5772926.70157068,8579311.0
8536,0,25000,57,183,,126,179.4,8418173.322222222,8579311.0
8537,2,1000,922,1205,6310,283,140.14,2989003.2716499544,7336579.66
8538,18,5000,978,1067,7173,89,140.14,8584355.493548388,7336579.66
8539,13,35000,1215,1237,7970,22,219.0,7795654.71978022,7652071.6
8540,24,5000,1321,1360,7640,39,219.0,23456062.532786883,7652071.6
8541,24,200000,1334,1334,8213,0,219.0,23456062.532786883,7652071.6
8542,6,50000,2066,2130,7859,64,166.1,1124713.2781954887,3498084.51
8543,24,50000,2469,2474,7183,5,230.03,23456062.532786883,14812242.86
8544,18,20000,2635,2665,7869,30,230.03,8584355.493548388,14812242.86
8545,17,15000,2727,2735,6487,8,417.96,1614143.0049603174,14954908.92
8546,21,2000000,3039,3083,7956,44,281.46,17091199.984,11503993.02
8547,8,60000,3042,3069,8243,27,281.46,1501617.2191780822,11503993.02
8548,0,3000000,3117,3308,6738,191,281.46,8418173.322222222,11503993.02
8549,7,759600,3348,3509,7299,161,281.46,3738553.685483871,11503993.02
8550,12,80000,3459,3495,6402,36,205.39,7658937.101338432,9006193.27
8551,7,8000,3672,3685,7900,13,205.39,3738553.685483871,9006193.27
8552,7,25000,4034,4084,7850,50,312.72,3738553.685483871,13350024.59
8553,7,500000,4079,4154,8246,75,312.72,3738553.685483871,13350024.59
8554,24,290000,4385,4399,8912,14,248.15,23456062.532786883,12693718.64
8555,21,1400,4413,4513,7597,100,248.15,17091199.984,12693718.64
8556,24,135000,4463,4471,8914,8,248.15,23456062.532786883,12693718.64
8557,9,50000,4534,4568,8202,34,258.28,3707403.8834951455,7314077.5
8558,18,12000000,4562,5282,7873,720,258.28,8584355.493548388,7314077.5
8559,0,60000,4686,6409,6415,1723,258.28,8418173.322222222,7314077.5
8560,21,15000,4751,4768,6639,17,258.28,17091199.984,7314077.5
8561,12,5000,4806,4880,7885,74,258.28,7658937.101338432,7314077.5
8562,18,100000,4959,5023,7334,64,253.83,8584355.493548388,6984378.81
8563,7,30000,5014,5043,7980,29,253.83,3738553.685483871,6984378.81
8564,24,10000,5045,5209,6493,164,253.83,23456062.532786883,6984378.81
8565,7,660300,5134,5178,7927,44,253.83,3738553.685483871,6984378.81
8566,15,50000,5164,5190,6414,26,253.83,4522577.48037889,6984378.81
8567,15,6500000,5330,5377,6681,47,246.12,4522577.48037889,6701891.81
8568,21,35000,5349,5428,6473,79,246.12,17091199.984,6701891.81
8569,1,35000,5352,5450,7376,98,246.12,3325419.7044334975,6701891.81
8570,2,5200000,5454,5521,7837,67,246.12,2989003.2716499544,6701891.81
8571,24,75000,5643,5654,7299,11,104.75,23456062.532786883,3369660.19
8572,24,500000,5673,5890,7786,217,104.75,23456062.532786883,3369660.19
8573,17,300000,5723,5799,7305,76,104.75,1614143.0049603174,3369660.19
8574,2,350000,5749,5762,8536,13,104.75,2989003.2716499544,3369660.19
8575,2,90000,5966,6002,8411,36,141.64,2989003.2716499544,5089136.37
8576,15,70000,5973,6014,7599,41,141.64,4522577.48037889,5089136.37
8577,23,150000,6002,6072,6631,70,141.64,5772926.70157068,5089136.37
8578,1,250000,6025,6053,6421,28,141.64,3325419.7044334975,5089136.37
8579,18,15000,6030,6067,6484,37,141.64,8584355.493548388,5089136.37
8580,17,500000,6035,6063,6772,28,141.64,1614143.0049603174,5089136.37
8581,15,200000,6046,6337,8402,291,141.64,4522577.48037889,5089136.37
8582,23,100000,6052,6120,6459,68,141.64,5772926.70157068,5089136.37
8583,21,2500000,6070,6112,7365,42,141.64,17091199.984,5089136.37
8584,22,1850000,6080,6312,7726,232,141.64,2904103.2512077293,5089136.37
8585,1,100000,6106,6170,6308,64,141.64,3325419.7044334975,5089136.37
8586,23,200000,6113,6155,7359,42,141.64,5772926.70157068,5089136.37
8587,24,100000,6127,6148,6372,21,141.64,23456062.532786883,5089136.37
8588,24,125000,6133,6248,6541,115,141.64,23456062.532786883,5089136.37
8589,24,200000,6152,6177,6331,25,141.64,23456062.532786883,5089136.37
8590,5,200000,6161,6212,6480,51,141.64,1400922.5020242915,5089136.37
8591,23,500000,6189,6415,6469,226,141.64,5772926.70157068,5089136.37
8592,19,300000,6210,6247,6323,37,141.64,6721340.5708154505,5089136.37
8593,11,100000,6219,6266,6385,47,141.64,1820371.57,5089136.37
8594,9,900000,6224,6415,6893,191,141.64,3707403.8834951455,5089136.37
8595,2,500000,6226,6382,8411,156,141.64,2989003.2716499544,5089136.37
8596,12,200000,6227,6270,6553,43,141.64,7658937.101338432,5089136.37
8597,23,100000,6235,6248,7898,13,141.64,5772926.70157068,5089136.37
8598,12,60000,6235,6269,6569,34,141.64,7658937.101338432,5089136.37
8599,24,10000,6238,6240,6448,2,141.64,23456062.532786883,5089136.37
8600,21,500000,6246,6274,6410,28,141.64,17091199.984,5089136.37
8601,24,350000,6263,6354,6634,91,141.64,23456062.532786883,5089136.37
8602,20,100000,6297,6331,6478,34,141.64,7597088.421768707,5089136.37
8603,15,30000,6298,6310,6653,12,141.64,4522577.48037889,5089136.37
8604,21,20000,6302,6431,6485,129,170.53,17091199.984,5237438.95
8605,15,50000,6317,6501,6526,184,170.53,4522577.48037889,5237438.95
8606,3,52000,6325,6360,6388,35,170.53,9246769.549865229,5237438.95
8607,17,200000,6329,6450,7781,121,170.53,1614143.0049603174,5237438.95
8608,9,10000,6330,6336,6408,6,170.53,3707403.8834951455,5237438.95
8609,8,50000,6339,6366,6469,27,170.53,1501617.2191780822,5237438.95
8610,23,150000,6340,6367,6464,27,170.53,5772926.70157068,5237438.95
8611,21,15000,6380,6394,6701,14,170.53,17091199.984,5237438.95
8612,21,800000,6422,6458,6772,36,170.53,17091199.984,5237438.95
8613,2,34400,6427,6476,6562,49,170.53,2989003.2716499544,5237438.95
8614,3,1300000,6431,6459,7407,28,170.53,9246769.549865229,5237438.95
8615,21,350000,6437,6452,6549,15,170.53,17091199.984,5237438.95
8616,11,162100,6448,6648,7458,200,170.53,1820371.57,5237438.95
8617,13,200000,6452,6484,6590,32,170.53,7795654.71978022,5237438.95
8618,24,100000,6465,6504,6683,39,170.53,23456062.532786883,5237438.95
8619,21,150000,6472,6478,6743,6,170.53,17091199.984,5237438.95
8620,15,50000,6490,6511,6646,21,170.53,4522577.48037889,5237438.95
8621,0,797000,6491,6571,6787,80,170.53,8418173.322222222,5237438.95
8622,21,400000,6515,6526,7424,11,170.53,17091199.984,5237438.95
8623,3,75000,6549,6557,7130,8,170.53,9246769.549865229,5237438.95
8624,24,3800000,6557,6577,7592,20,170.53,23456062.532786883,5237438.95
8625,2,40000,6557,6609,6673,52,170.53,2989003.2716499544,5237438.95
8626,1,90000,6560,6634,6652,74,170.53,3325419.7044334975,5237438.95
8627,17,40000,6562,6611,6721,49,170.53,1614143.0049603174,5237438.95
8628,3,10000,6591,6707,6891,116,170.53,9246769.549865229,5237438.95
8629,21,80000,6595,6603,6877,8,170.53,17091199.984,5237438.95
8630,24,100000,6598,6611,7134,13,170.53,23456062.532786883,5237438.95
8631,4,150000,6617,6680,7008,63,170.53,4297914.794871795,5237438.95
8632,24,100000,6620,6644,6967,24,170.53,23456062.532786883,5237438.95
8633,21,250000,6640,6673,6934,33,170.53,17091199.984,5237438.95
8634,24,350000,6647,6667,7276,20,170.53,23456062.532786883,5237438.95
8635,24,300000,6648,6682,6918,34,170.53,23456062.532786883,5237438.95
8636,24,100000,6651,6686,7017,35,170.53,23456062.532786883,5237438.95
8637,2,150000,6654,6819,7065,165,170.53,2989003.2716499544,5237438.95
8638,23,400000,6655,6693,6935,38,170.53,5772926.70157068,5237438.95
8639,1,800000,6687,6770,7723,83,159.56,3325419.7044334975,6271224.19
8640,11,80000,6687,6697,6778,10,159.56,1820371.57,6271224.19
8641,24,200000,6732,6764,6947,32,159.56,23456062.532786883,6271224.19
8642,21,100000,6773,6802,7541,29,159.56,17091199.984,6271224.19
8643,18,60000,6779,6819,6962,40,159.56,8584355.493548388,6271224.19
8644,11,800000,6781,6836,7298,55,159.56,1820371.57,6271224.19
8645,11,2000000,6795,6933,7463,138,159.56,1820371.57,6271224.19
8646,21,577000,6815,6822,7365,7,159.56,17091199.984,6271224.19
8647,9,500000,6827,6877,7072,50,159.56,3707403.8834951455,6271224.19
8648,5,40000,6842,6872,6914,30,159.56,1400922.5020242915,6271224.19
8649,24,150000,6843,6900,7165,57,159.56,23456062.532786883,6271224.19
8650,21,150000,6849,6865,7061,16,159.56,17091199.984,6271224.19
8651,24,600000,6858,6871,7033,13,159.56,23456062.532786883,6271224.19
8652,3,150000,6863,6914,7599,51,159.56,9246769.549865229,6271224.19
8653,4,15000,6868,6924,6949,56,159.56,4297914.794871795,6271224.19
8654,13,50000,6889,6913,7012,24,159.56,7795654.71978022,6271224.19
8655,1,50000,6890,6914,7071,24,159.56,3325419.7044334975,6271224.19
8656,19,15000,6912,6938,7106,26,159.56,6721340.5708154505,6271224.19
8657,23,500000,6926,6984,7576,58,159.56,5772926.70157068,6271224.19
8658,12,150000,6927,6966,7058,39,159.56,7658937.101338432,6271224.19
8659,6,100000,6931,7130,7829,199,159.56,1124713.2781954887,6271224.19
8660,23,200000,6939,6976,7108,37,159.56,5772926.70157068,6271224.19
8661,24,200000,6941,6968,7152,27,159.56,23456062.532786883,6271224.19
8662,13,1000000,6954,6973,7428,19,159.56,7795654.71978022,6271224.19
8663,12,5000,6955,6991,7101,36,159.56,7658937.101338432,6271224.19
8664,3,80000,6968,6982,7082,14,159.56,9246769.549865229,6271224.19
8665,24,100000,6969,7011,7194,42,159.56,23456062.532786883,6271224.19
8666,23,70000,6969,6990,7075,21,159.56,5772926.70157068,6271224.19
8667,21,60000,6981,6983,7079,2,159.56,17091199.984,6271224.19
8668,18,100000,6984,7011,7093,27,159.56,8584355.493548388,6271224.19
8669,1,150000,7005,7080,7185,75,159.56,3325419.7044334975,6271224.19
8670,13,750000,7009,7103,7829,94,159.56,7795654.71978022,6271224.19
8671,24,10000,7044,7079,7121,35,155.74,23456062.532786883,6918446.56
8672,19,500000,7052,7067,7394,15,155.74,6721340.5708154505,6918446.56
8673,22,130000,7059,7137,7253,78,155.74,2904103.2512077293,6918446.56
8674,24,400000,7059,7108,8906,49,155.74,23456062.532786883,6918446.56
8675,8,10000,7065,7171,7297,106,155.74,1501617.2191780822,6918446.56
8676,12,40000,7075,7100,7158,25,155.74,7658937.101338432,6918446.56
8677,23,500000,7082,7101,7208,19,155.74,5772926.70157068,6918446.56
8678,15,95000,7099,7122,7253,23,155.74,4522577.48037889,6918446.56
8679,9,20000,7100,7156,7322,56,155.74,3707403.8834951455,6918446.56
8680,16,1000000,7110,7158,7704,48,155.74,2465023.1840707962,6918446.56
8681,17,10000000,7148,7240,7555,92,155.74,1614143.0049603174,6918446.56
8682,6,150000,7152,7158,7276,6,155.74,1124713.2781954887,6918446.56
8683,15,70000,7164,7200,7366,36,155.74,4522577.48037889,6918446.56
8684,21,300000,7194,7214,8500,20,155.74,17091199.984,6918446.56
8685,12,100000,7200,7254,7457,54,155.74,7658937.101338432,6918446.56
8686,21,500000,7205,7239,7855,34,155.74,17091199.984,6918446.56
8687,21,150000,7214,7253,8074,39,155.74,17091199.984,6918446.56
8688,17,75000,7219,7318,7451,99,155.74,1614143.0049603174,6918446.56
8689,20,45000,7228,7235,7429,7,155.74,7597088.421768707,6918446.56
8690,21,120000,7241,7295,7485,54,155.74,17091199.984,6918446.56
8691,5,100000,7248,7264,7437,16,155.74,1400922.5020242915,6918446.56
8692,6,200000,7257,7325,7373,68,155.74,1124713.2781954887,6918446.56
8693,21,70000,7269,7400,7771,131,155.74,17091199.984,6918446.56
8694,3,30000,7269,7275,7359,6,155.74,9246769.549865229,6918446.56
8695,20,250000,7291,7323,7516,32,155.74,7597088.421768707,6918446.56
8696,24,150000,7296,7439,7682,143,155.74,23456062.532786883,6918446.56
8697,17,50000,7320,7340,7501,20,155.74,1614143.0049603174,6918446.56
8698,23,600000,7322,7354,7592,32,155.74,5772926.70157068,6918446.56
8699,21,200000,7325,7340,7438,15,155.74,17091199.984,6918446.56
8700,24,250000,7346,7386,7781,40,155.74,23456062.532786883,6918446.56
8701,1,1000000,7355,7459,7717,104,155.74,3325419.7044334975,6918446.56
8702,24,50000,7365,7515,8591,150,155.74,23456062.532786883,6918446.56
8703,12,250000,7396,7429,7682,33,152.24,7658937.101338432,6303424.81
8704,13,75000,7396,7430,7593,34,152.24,7795654.71978022,6303424.81
8705,13,50000,7416,7444,7799,28,152.24,7795654.71978022,6303424.81
8706,13,100000,7428,7443,7786,15,152.24,7795654.71978022,6303424.81
8707,3,715000,7431,7460,8922,29,152.24,9246769.549865229,6303424.81
8708,24,10000,7437,7456,8090,19,152.24,23456062.532786883,6303424.81
8709,21,100000,7449,7544,7955,95,152.24,17091199.984,6303424.81
8710,19,50000,7452,7502,7814,50,152.24,6721340.5708154505,6303424.81
8711,21,200000,7491,7516,8123,25,152.24,17091199.984,6303424.81
8712,12,230000,7499,7516,7943,17,152.24,7658937.101338432,6303424.81
8713,17,80000,7543,7569,7682,26,152.24,1614143.0049603174,6303424.81
8714,20,20000,7554,7579,8416,25,152.24,7597088.421768707,6303424.81
8715,3,10000,7564,7603,8018,39,152.24,9246769.549865229,6303424.81
8716,22,60000,7627,7724,8220,97,152.24,2904103.2512077293,6303424.81
8717,23,30000,7690,7697,7946,7,152.24,5772926.70157068,6303424.81
8718,3,4000000,7723,7747,8095,24,152.24,9246769.549865229,6303424.81
8719,24,10000,7737,7775,7900,38,152.24,23456062.532786883,6303424.81
8720,20,90000,7746,7787,7867,41,152.24,7597088.421768707,6303424.81
8721,20,20000,7767,7785,8832,18,120.16,7597088.421768707,3586324.4
8722,21,1000000,7775,7837,8212,62,120.16,17091199.984,3586324.4
8723,10,70000,7808,7841,8348,33,120.16,8282326.220930233,3586324.4
8724,24,250000,7814,7823,8152,9,120.16,23456062.532786883,3586324.4
8725,3,60000,7815,7823,8010,8,120.16,9246769.549865229,3586324.4
8726,24,40000,7817,7836,8382,19,120.16,23456062.532786883,3586324.4
8727,4,10000,7842,7862,7940,20,120.16,4297914.794871795,3586324.4
8728,21,1100000,7866,7883,8378,17,120.16,17091199.984,3586324.4
8729,2,1653643,7891,7921,8263,30,120.16,2989003.2716499544,3586324.4
8730,2,90000,7895,7918,8096,23,120.16,2989003.2716499544,3586324.4
8731,24,350000,7901,7933,8118,32,120.16,23456062.532786883,3586324.4
8732,24,50000,7921,7950,8106,29,120.16,23456062.532786883,3586324.4
8733,10,20000,7934,7949,8109,15,120.16,8282326.220930233,3586324.4
8734,20,70000,7989,8020,8748,31,120.16,7597088.421768707,3586324.4
8735,20,50000,7992,7999,8261,7,120.16,7597088.421768707,3586324.4
8736,21,1800000,7993,8100,8780,107,120.16,17091199.984,3586324.4
8737,24,175000,8004,8026,8265,22,120.16,23456062.532786883,3586324.4
8738,2,1200000,8005,8093,8227,88,120.16,2989003.2716499544,3586324.4
8739,9,385000,8010,8068,8205,58,120.16,3707403.8834951455,3586324.4
8740,4,2500000,8027,8045,8229,18,120.16,4297914.794871795,3586324.4
8741,21,175000,8061,8086,8500,25,120.16,17091199.984,3586324.4
8742,24,612500,8121,8159,8522,38,120.16,23456062.532786883,3586324.4
8743,15,400000,8180,8222,8521,42,99.44,4522577.48037889,1975331.43
8744,5,100000,8181,8229,8305,48,99.44,1400922.5020242915,1975331.43
8745,24,20000,8228,8248,8858,20,99.44,23456062.532786883,1975331.43
8746,5,150000,8251,8284,8425,33,99.44,1400922.5020242915,1975331.43
8747,2,150000,8261,8310,8391,49,99.44,2989003.2716499544,1975331.43
8748,3,250000,8261,8293,8431,32,99.44,9246769.549865229,1975331.43
8749,21,200000,8271,8296,8838,25,99.44,17091199.984,1975331.43
8750,3,900000,8304,8347,8628,43,99.44,9246769.549865229,1975331.43
8751,24,100000000,8369,8405,8625,36,99.44,23456062.532786883,1975331.43
8752,23,500000,8398,8578,8871,180,99.44,5772926.70157068,1975331.43
8753,21,40000,8405,8430,8555,25,99.44,17091199.984,1975331.43
8754,18,50000,8430,8482,8691,52,99.44,8584355.493548388,1975331.43
8755,17,100000,8482,8564,8733,82,99.44,1614143.0049603174,1975331.43
8756,18,200000,8551,8668,8898,117,65.64,8584355.493548388,1503028.14
8757,24,75000,8584,8608,8780,24,65.64,23456062.532786883,1503028.14
8758,18,85000,8633,8676,8761,43,65.64,8584355.493548388,1503028.14
8759,8,300000,8646,8754,8922,108,65.64,1501617.2191780822,1503028.14
8760,9,80000,8698,8727,8920,29,65.64,3707403.8834951455,1503028.14
8761,2,250000,8702,8703,8874,1,65.64,2989003.2716499544,1503028.14
8762,2,60000,8723,8753,8822,30,65.64,2989003.2716499544,1503028.14
